,County,2010 Median Rent Price,2011 Median Rent Price,2012 Median Rent Price,2013 Median Rent Price,2014 Median Rent Price,2015 Median Rent Price,2016 Median Rent Price,2011 Rent Difference,2012 Rent Difference,2013 Rent Difference,2014 Rent Difference,2015 Rent Difference,2016 Rent Difference,2011 Rent Percent Change,2012 Rent Percent Change,2013 Rent Percent Change,2014 Rent Percent Change,2015 Rent Percent Change,2016 Rent Percent Change
0,2166,1059,1154,1073,1080,1130,1207,1137,95,-81,7,50,77,-70,8.970727101,-7.019064125,0.652376514,4.62962963,6.814159292,-5.7995029
1,1694,1262,1329,1392,1348,1193,1277,1255,67,63,-44,-155,84,-22,5.309033281,4.740406321,-3.16091954,-11.49851632,7.041072925,-1.722787784
2,2546,997,936,864,860,981,985,938,-61,-72,-4,121,4,-47,-6.118355065,-7.692307692,-0.462962963,14.06976744,0.407747197,-4.771573604
3,108,1214,1289,1348,1461,1588,1714,1790,75,59,113,127,126,76,6.177924217,4.577191621,8.382789318,8.692676249,7.934508816,4.434072345
4,2796,929,864,835,825,912,937,823,-65,-29,-10,87,25,-114,-6.996770721,-3.356481481,-1.19760479,10.54545455,2.74122807,-12.16648879
5,784,865,941,971,1048,1029,1117,1104,76,30,77,-19,88,-13,8.786127168,3.188097768,7.929969104,-1.812977099,8.551992225,-1.163831692
6,808,765,840,841,878,872,894,904,75,1,37,-6,22,10,9.803921569,0.119047619,4.399524376,-0.683371298,2.52293578,1.118568233
7,370,1200,1196,1166,1194,1179,1258,1244,-4,-30,28,-15,79,-14,-0.333333333,-2.508361204,2.401372213,-1.256281407,6.700593723,-1.112877583
8,2254,1045,1112,1093,1077,1122,1102,1151,67,-19,-16,45,-20,49,6.411483254,-1.708633094,-1.463860933,4.178272981,-1.782531194,4.44646098
9,259,815,945,809,848,811,831,835,130,-136,39,-37,20,4,15.95092025,-14.39153439,4.820766378,-4.363207547,2.466091245,0.481347774
10,1241,1067,1086,1107,1179,1169,1201,1250,19,21,72,-10,32,49,1.780693533,1.933701657,6.504065041,-0.848176421,2.737382378,4.079933389
11,1292,926,944,894,860,899,909,952,18,-50,-34,39,10,43,1.943844492,-5.296610169,-3.803131991,4.534883721,1.112347052,4.730473047
12,16,2106,2100,2136,2308,2596,2933,3067,-6,36,172,288,337,134,-0.284900285,1.714285714,8.052434457,12.47833622,12.98151002,4.568700989
13,149,1576,1462,1472,1476,1508,1615,1677,-114,10,4,32,107,62,-7.233502538,0.683994528,0.27173913,2.16802168,7.095490716,3.839009288
14,376,1422,1483,1499,1577,1587,1643,1702,61,16,78,10,56,59,4.289732771,1.078894134,5.203468979,0.634115409,3.528670447,3.590992088
15,290,2227,2319,2304,2406,2433,2458,2462,92,-15,102,27,25,4,4.131118096,-0.64683053,4.427083333,1.122194514,1.027538019,0.16273393
16,2134,1048,920,968,908,926,1009,1041,-128,48,-60,18,83,32,-12.21374046,5.217391304,-6.198347107,1.982378855,8.963282937,3.171456888
17,1005,969,913,990,1027,985,992,913,-56,77,37,-42,7,-79,-5.779153767,8.43373494,3.737373737,-4.089581305,0.710659898,-7.963709677
18,456,1148,1174,1188,1105,1121,1113,1100,26,14,-83,16,-8,-13,2.264808362,1.192504259,-6.986531987,1.447963801,-0.713648528,-1.168014376
19,23,1074,963,1013,1115,1153,1170,1178,-111,50,102,38,17,8,-10.33519553,5.192107996,10.06910168,3.408071749,1.474414571,0.683760684
20,1205,949,888,952,962,950,989,1060,-61,64,10,-12,39,71,-6.427818757,7.207207207,1.050420168,-1.247401247,4.105263158,7.178968655
21,3086,984,1044,937,993,1139,1142,964,60,-107,56,146,3,-178,6.097560976,-10.24904215,5.976520811,14.70292044,0.263388938,-15.58669002
22,355,804,838,847,839,871,888,913,34,9,-8,32,17,25,4.228855721,1.07398568,-0.944510035,3.814064362,1.951779564,2.815315315
23,1732,1134,943,863,871,851,895,874,-191,-80,8,-20,44,-21,-16.84303351,-8.483563097,0.926998841,-2.296211251,5.170387779,-2.346368715
24,710,1481,1235,1137,1160,1293,1394,1541,-246,-98,23,133,101,147,-16.61039838,-7.935222672,2.022867194,11.46551724,7.81129157,10.54519369
25,2114,1200,1177,1200,1272,1326,1217,1146,-23,23,72,54,-109,-71,-1.916666667,1.954120646,6,4.245283019,-8.220211161,-5.834018077
26,777,1071,1089,1076,1122,1099,1136,1140,18,-13,46,-23,37,4,1.680672269,-1.193755739,4.275092937,-2.049910873,3.366696997,0.352112676
27,1846,1009,975,934,997,998,1044,1055,-34,-41,63,1,46,11,-3.369672944,-4.205128205,6.745182013,0.100300903,4.609218437,1.053639847
28,223,965,841,907,954,979,977,992,-124,66,47,25,-2,15,-12.84974093,7.847800238,5.181918412,2.620545073,-0.204290092,1.53531218
29,455,897,902,846,938,919,911,920,5,-56,92,-19,-8,9,0.557413601,-6.208425721,10.87470449,-2.025586354,-0.870511425,0.987925357
30,1485,1066,1045,1083,1122,1092,1099,1129,-21,38,39,-30,7,30,-1.969981238,3.636363636,3.601108033,-2.673796791,0.641025641,2.729754322
31,2291,1095,1109,1105,1101,1138,1339,1307,14,-4,-4,37,201,-32,1.278538813,-0.360685302,-0.36199095,3.36058129,17.66256591,-2.389843167
32,1390,1131,1099,854,816,1023,1043,1152,-32,-245,-38,207,20,109,-2.829354553,-22.29299363,-4.449648712,25.36764706,1.955034213,10.4506232
33,83,1812,1802,1824,1907,1921,1969,2009,-10,22,83,14,48,40,-0.55187638,1.220865705,4.550438596,0.734137389,2.498698594,2.031488065
34,139,1292,1390,1375,1453,1455,1485,1511,98,-15,78,2,30,26,7.585139319,-1.079136691,5.672727273,0.137646249,2.06185567,1.750841751
35,825,766,789,799,816,779,777,780,23,10,17,-37,-2,3,3.002610966,1.267427123,2.127659574,-4.534313725,-0.256739409,0.386100386
36,1818,1143,941,1106,1080,986,1080,1103,-202,165,-26,-94,94,23,-17.6727909,17.53453773,-2.350813743,-8.703703704,9.53346856,2.12962963
37,2288,1123,1124,1130,1164,1154,1169,1143,1,6,34,-10,15,-26,0.089047195,0.533807829,3.008849558,-0.859106529,1.29982669,-2.224123182
38,1824,1283,1269,1347,1377,1433,1515,1507,-14,78,30,56,82,-8,-1.091192518,6.146572104,2.227171492,4.06681191,5.722260991,-0.528052805
39,78,1301,1402,1489,1597,1772,1911,1948,101,87,108,175,139,37,7.763259032,6.205420827,7.25319006,10.95804634,7.844243792,1.936159079
40,2375,1233,1195,1182,1261,1319,1348,1336,-38,-13,79,58,29,-12,-3.081914031,-1.087866109,6.68358714,4.599524187,2.19863533,-0.890207715
41,1044,1333,1354,1368,1357,1391,1541,1635,21,14,-11,34,150,94,1.575393848,1.033973412,-0.804093567,2.505526898,10.78360891,6.099935107
42,1920,1044,837,798,791,841,885,831,-207,-39,-7,50,44,-54,-19.82758621,-4.659498208,-0.877192982,6.321112516,5.231866825,-6.101694915
43,202,2617,2677,2704,2742,2769,2761,2850,60,27,38,27,-8,89,2.292701567,1.008591707,1.405325444,0.984682713,-0.288912965,3.223469757
44,821,1031,1058,1111,1181,1118,1162,1167,27,53,70,-63,44,5,2.618816683,5.009451796,6.300630063,-5.33446232,3.935599284,0.430292599
45,368,871,864,871,869,917,942,951,-7,7,-2,48,25,9,-0.803673938,0.810185185,-0.229621125,5.523590334,2.726281352,0.955414013
46,1842,1160,1190,1169,1169,1230,1271,1301,30,-21,0,61,41,30,2.586206897,-1.764705882,0,5.218135158,3.333333333,2.360346184
47,2269,739,757,827,834,807,795,834,18,70,7,-27,-12,39,2.435723951,9.247027741,0.84643289,-3.237410072,-1.486988848,4.905660377
48,498,1332,1342,1047,962,1098,1143,1167,10,-295,-85,136,45,24,0.750750751,-21.98211624,-8.11843362,14.13721414,4.098360656,2.099737533
49,163,1556,1477,1535,1511,1468,1560,1505,-79,58,-24,-43,92,-55,-5.077120823,3.926878808,-1.563517915,-2.845797485,6.267029973,-3.525641026
50,1792,903,864,825,825,875,857,887,-39,-39,0,50,-18,30,-4.318936877,-4.513888889,0,6.060606061,-2.057142857,3.500583431
51,2778,932,934,902,850,1012,1068,968,2,-32,-52,162,56,-100,0.214592275,-3.426124197,-5.764966741,19.05882353,5.533596838,-9.36329588
52,461,1181,1224,1150,1263,1271,1287,1309,43,-74,113,8,16,22,3.640982218,-6.045751634,9.826086957,0.63341251,1.258851298,1.709401709
53,1749,1341,1285,1303,1407,1408,1549,1515,-56,18,104,1,141,-34,-4.175988069,1.40077821,7.981580967,0.071073205,10.01420455,-2.194964493
54,1505,946,940,912,1021,994,1005,1047,-6,-28,109,-27,11,42,-0.634249471,-2.978723404,11.95175439,-2.64446621,1.106639839,4.179104478
55,1893,1124,1310,1438,1227,1158,1231,1087,186,128,-211,-69,73,-144,16.5480427,9.770992366,-14.67315716,-5.623471883,6.303972366,-11.69780666
56,1766,1110,1133,1139,1195,1180,1189,1198,23,6,56,-15,9,9,2.072072072,0.52956752,4.916593503,-1.255230126,0.762711864,0.756938604
57,228,1139,1027,1126,1246,1283,1377,1425,-112,99,120,37,94,48,-9.833187006,9.639727361,10.65719361,2.969502408,7.326578332,3.48583878
58,1562,1080,1066,1025,1066,1007,1030,1043,-14,-41,41,-59,23,13,-1.296296296,-3.846153846,4,-5.534709193,2.284011917,1.262135922
59,73,1186,1201,1230,1244,1287,1316,1302,15,29,14,43,29,-14,1.264755481,2.414654455,1.138211382,3.45659164,2.253302253,-1.063829787
60,48,1590,1580,1610,1640,1642,1668,1683,-10,30,30,2,26,15,-0.628930818,1.898734177,1.863354037,0.12195122,1.583434836,0.899280576
61,2077,1097,1002,972,1018,1059,1134,1147,-95,-30,46,41,75,13,-8.659981768,-2.994011976,4.732510288,4.027504912,7.082152975,1.14638448
62,196,1544,1541,1603,1610,1828,1827,1883,-3,62,7,218,-1,56,-0.194300518,4.023361454,0.436681223,13.54037267,-0.054704595,3.0651341
63,881,850,890,880,911,907,942,894,40,-10,31,-4,35,-48,4.705882353,-1.123595506,3.522727273,-0.439077936,3.858875413,-5.095541401
64,1593,915,904,895,875,942,912,975,-11,-9,-20,67,-30,63,-1.202185792,-0.995575221,-2.234636872,7.657142857,-3.184713376,6.907894737
65,1561,777,991,1052,1095,1062,1013,1095,214,61,43,-33,-49,82,27.54182754,6.155398587,4.087452471,-3.01369863,-4.61393597,8.094768016
66,1443,998,963,994,997,1008,1077,1162,-35,31,3,11,69,85,-3.507014028,3.219106957,0.301810865,1.10330993,6.845238095,7.892293408
67,1414,1021,991,1031,1082,1130,1142,1212,-30,40,51,48,12,70,-2.938295788,4.036326942,4.946653734,4.436229205,1.061946903,6.129597198
68,2043,652,717,819,762,769,744,744,65,102,-57,7,-25,0,9.969325153,14.22594142,-6.95970696,0.918635171,-3.250975293,0
69,1362,991,911,863,914,957,1021,1012,-80,-48,51,43,64,-9,-8.072653885,-5.268935236,5.909617613,4.704595186,6.687565308,-0.881488737
70,1428,1170,1015,1149,1193,1304,1354,1375,-155,134,44,111,50,21,-13.24786325,13.20197044,3.829416884,9.304274937,3.834355828,1.550960118
71,678,815,866,885,941,948,930,973,51,19,56,7,-18,43,6.257668712,2.193995381,6.327683616,0.743889479,-1.898734177,4.623655914
72,1279,1201,1076,1053,1149,1193,1277,1316,-125,-23,96,44,84,39,-10.40799334,-2.137546468,9.116809117,3.829416884,7.041072925,3.05403289
73,1353,975,765,793,809,806,831,853,-210,28,16,-3,25,22,-21.53846154,3.660130719,2.017654477,-0.370828183,3.101736973,2.647412756
74,1543,1143,1065,1030,1090,1102,1095,1002,-78,-35,60,12,-7,-93,-6.824146982,-3.286384977,5.825242718,1.100917431,-0.635208711,-8.493150685
75,253,1233,1298,1354,1408,1588,1784,1828,65,56,54,180,196,44,5.271695053,4.314329738,3.988183161,12.78409091,12.34256927,2.466367713
76,1660,1122,1195,1097,1328,1201,1153,1168,73,-98,231,-127,-48,15,6.506238859,-8.20083682,21.05742935,-9.563253012,-3.996669442,1.300954033
77,239,1025,890,991,1002,1005,1084,1038,-135,101,11,3,79,-46,-13.17073171,11.34831461,1.109989909,0.299401198,7.860696517,-4.243542435
78,775,1184,1231,1240,1291,1300,1347,1286,47,9,51,9,47,-61,3.969594595,0.731112916,4.112903226,0.697134005,3.615384615,-4.528582034
79,892,759,792,868,979,965,981,882,33,76,111,-14,16,-99,4.347826087,9.595959596,12.78801843,-1.430030644,1.658031088,-10.09174312
80,2431,1022,1000,1004,1052,990,1051,1085,-22,4,48,-62,61,34,-2.152641879,0.4,4.780876494,-5.893536122,6.161616162,3.235014272
81,596,1061,1025,1076,1188,1135,1106,1104,-36,51,112,-53,-29,-2,-3.393025448,4.975609756,10.40892193,-4.461279461,-2.555066079,-0.180831826
82,1567,949,920,954,962,1009,1011,1125,-29,34,8,47,2,114,-3.055848261,3.695652174,0.838574423,4.885654886,0.198216056,11.27596439
83,479,1153,1197,1086,1149,1156,1179,1224,44,-111,63,7,23,45,3.81613183,-9.273182957,5.801104972,0.609225413,1.989619377,3.816793893
84,1480,1200,1137,1194,1200,1239,1191,1288,-63,57,6,39,-48,97,-5.25,5.013192612,0.502512563,3.25,-3.87409201,8.144416457
85,1214,1100,979,1044,999,1020,1036,1058,-121,65,-45,21,16,22,-11,6.639427988,-4.310344828,2.102102102,1.568627451,2.123552124
86,645,1160,1168,1145,1229,1196,1241,1213,8,-23,84,-33,45,-28,0.689655172,-1.969178082,7.336244541,-2.685109845,3.762541806,-2.256244964
87,191,885,902,985,1000,1020,1099,1139,17,83,15,20,79,40,1.920903955,9.201773836,1.52284264,2,7.745098039,3.639672429
88,2381,808,757,751,759,831,820,833,-51,-6,8,72,-11,13,-6.311881188,-0.792602378,1.065246338,9.486166008,-1.323706378,1.585365854
89,235,1266,1374,1243,1253,1311,1445,1489,108,-131,10,58,134,44,8.530805687,-9.534206696,0.804505229,4.628890662,10.22120519,3.044982699
90,1896,1200,1032,1107,1048,1031,1135,1146,-168,75,-59,-17,104,11,-14,7.26744186,-5.329719964,-1.622137405,10.08729389,0.969162996
91,39,2166,2154,2165,2258,2522,2433,2438,-12,11,93,264,-89,5,-0.55401662,0.510677809,4.295612009,11.69176262,-3.528945282,0.205507604
92,232,1083,1136,1141,1202,1271,1288,1340,53,5,61,69,17,52,4.893813481,0.440140845,5.346187555,5.740432612,1.337529504,4.037267081
93,1359,1100,1171,1151,1174,1205,1199,1214,71,-20,23,31,-6,15,6.454545455,-1.70794193,1.998262381,2.640545145,-0.497925311,1.251042535
94,119,1200,1242,1202,1251,1222,1296,1283,42,-40,49,-29,74,-13,3.5,-3.220611916,4.076539101,-2.318145484,6.055646481,-1.00308642
95,306,1397,1525,1234,1394,1353,1509,1533,128,-291,160,-41,156,24,9.162491052,-19.08196721,12.96596434,-2.941176471,11.52993348,1.590457256
96,1872,983,949,963,942,960,948,968,-34,14,-21,18,-12,20,-3.458799593,1.475237092,-2.180685358,1.910828025,-1.25,2.109704641
97,1287,1180,848,929,1189,1232,1097,1031,-332,81,260,43,-135,-66,-28.13559322,9.551886792,27.98708288,3.616484441,-10.95779221,-6.016408387
98,1161,1074,1066,1098,1156,1196,1247,1278,-8,32,58,40,51,31,-0.744878957,3.001876173,5.282331512,3.460207612,4.264214047,2.485966319
99,307,937,911,860,957,904,1001,1032,-26,-51,97,-53,97,31,-2.774813234,-5.598243688,11.27906977,-5.538140021,10.7300885,3.096903097
100,2113,732,680,692,707,720,716,720,-52,12,15,13,-4,4,-7.103825137,1.764705882,2.167630058,1.838755304,-0.555555556,0.558659218
101,2176,885,845,899,870,830,830,805,-40,54,-29,-40,0,-25,-4.519774011,6.390532544,-3.225806452,-4.597701149,0,-3.012048193
102,1963,1823,1481,1587,1448,1565,1849,1832,-342,106,-139,117,284,-17,-18.76028524,7.157326131,-8.758664146,8.080110497,18.14696486,-0.9194159
103,2526,959,948,956,960,956,903,943,-11,8,4,-4,-53,40,-1.147028154,0.843881857,0.418410042,-0.416666667,-5.543933054,4.429678848
104,319,959,950,985,1057,1042,1104,1113,-9,35,72,-15,62,9,-0.938477581,3.684210526,7.30964467,-1.419110691,5.950095969,0.815217391
105,502,1219,1233,1236,1253,1276,1315,1350,14,3,17,23,39,35,1.148482363,0.243309002,1.375404531,1.835594573,3.056426332,2.661596958
106,1493,1345,1289,1241,1256,1380,1394,1425,-56,-48,15,124,14,31,-4.163568773,-3.723816912,1.208702659,9.872611465,1.014492754,2.223816356
107,327,1119,1197,1089,1281,1329,1397,1408,78,-108,192,48,68,11,6.970509383,-9.022556391,17.63085399,3.7470726,5.116629044,0.787401575
108,1281,990,1057,1137,1115,1145,1163,1173,67,80,-22,30,18,10,6.767676768,7.56859035,-1.934916447,2.69058296,1.572052402,0.859845228
109,1886,1136,1091,1058,1116,1068,1130,1137,-45,-33,58,-48,62,7,-3.961267606,-3.024747938,5.482041588,-4.301075269,5.805243446,0.619469027
110,1335,1079,1174,1141,1365,1370,1342,1336,95,-33,224,5,-28,-6,8.804448563,-2.810902896,19.63190184,0.366300366,-2.04379562,-0.44709389
111,764,1172,1209,1197,1236,1268,1229,1232,37,-12,39,32,-39,3,3.156996587,-0.992555831,3.258145363,2.588996764,-3.075709779,0.244100895
112,155,1706,1784,1921,2051,2092,2271,2235,78,137,130,41,179,-36,4.572098476,7.679372197,6.767308693,1.999024866,8.556405354,-1.585204756
113,927,1010,1017,953,956,1011,966,1017,7,-64,3,55,-45,51,0.693069307,-6.293018682,0.314795383,5.753138075,-4.451038576,5.279503106
114,1378,1140,1109,859,831,880,897,1081,-31,-250,-28,49,17,184,-2.719298246,-22.54283138,-3.259604191,5.896510229,1.931818182,20.51282051
115,1533,856,839,888,908,849,877,889,-17,49,20,-59,28,12,-1.985981308,5.840286055,2.252252252,-6.497797357,3.297997644,1.368301026
116,1748,999,1003,954,988,1002,1038,1018,4,-49,34,14,36,-20,0.4004004,-4.885343968,3.5639413,1.417004049,3.592814371,-1.926782274
117,1746,955,994,1026,1069,1052,1087,1105,39,32,43,-17,35,18,4.083769634,3.219315895,4.191033138,-1.590271282,3.326996198,1.655933763
118,509,1200,1239,1282,1291,1205,1080,1111,39,43,9,-86,-125,31,3.25,3.470540759,0.702028081,-6.661502711,-10.37344398,2.87037037
119,377,969,924,948,978,968,979,965,-45,24,30,-10,11,-14,-4.643962848,2.597402597,3.164556962,-1.022494888,1.136363636,-1.430030644
120,1565,1086,906,855,886,933,955,977,-180,-51,31,47,22,22,-16.57458564,-5.629139073,3.625730994,5.304740406,2.357984995,2.303664921
121,1213,1310,1405,1474,1515,1625,1711,1699,95,69,41,110,86,-12,7.251908397,4.911032028,2.781546811,7.260726073,5.292307692,-0.701344243
122,925,862,840,852,836,860,847,894,-22,12,-16,24,-13,47,-2.552204176,1.428571429,-1.877934272,2.870813397,-1.511627907,5.548996458
123,861,1243,1044,1157,1097,1116,1095,1125,-199,113,-60,19,-21,30,-16.00965406,10.82375479,-5.185825411,1.731996354,-1.88172043,2.739726027
124,1188,961,997,1071,1110,1182,1251,1332,36,74,39,72,69,81,3.746097815,7.4222668,3.641456583,6.486486486,5.837563452,6.474820144
125,2372,1051,1052,1064,1120,1187,1302,1344,1,12,56,67,115,42,0.095147479,1.140684411,5.263157895,5.982142857,9.688289806,3.225806452
126,949,921,889,908,945,976,965,971,-32,19,37,31,-11,6,-3.474484256,2.137232846,4.074889868,3.28042328,-1.12704918,0.621761658
127,80,1475,1486,1459,1491,1533,1714,1646,11,-27,32,42,181,-68,0.745762712,-1.816958277,2.193283071,2.816901408,11.80691455,-3.967327888
128,595,1789,1689,1783,1795,1785,1991,2068,-100,94,12,-10,206,77,-5.589714925,5.565423327,0.673022995,-0.557103064,11.54061625,3.867403315
129,20,1761,1531,1588,1640,1734,1811,1771,-230,57,52,94,77,-40,-13.06076093,3.723056826,3.274559194,5.731707317,4.440599769,-2.208724462
130,2053,874,888,873,888,874,770,745,14,-15,15,-14,-104,-25,1.601830664,-1.689189189,1.718213058,-1.576576577,-11.8993135,-3.246753247
131,2276,923,928,946,937,943,945,936,5,18,-9,6,2,-9,0.541711809,1.939655172,-0.951374207,0.640341515,0.212089077,-0.952380952
132,211,1278,1259,982,930,1139,1063,1158,-19,-277,-52,209,-76,95,-1.486697966,-22.00158856,-5.295315682,22.47311828,-6.672519754,8.936970837
133,550,1495,1649,1639,1773,1963,2124,2115,154,-10,134,190,161,-9,10.30100334,-0.606428138,8.175716901,10.71630006,8.201732043,-0.423728814
134,1160,1494,1532,1569,1609,1653,1715,1776,38,37,40,44,62,61,2.543507363,2.415143603,2.549394519,2.734617775,3.750756201,3.556851312
135,1928,1187,1110,1047,1116,1161,1163,1171,-77,-63,69,45,2,8,-6.48694187,-5.675675676,6.59025788,4.032258065,0.172265289,0.687876182
136,2358,679,752,777,785,787,740,751,73,25,8,2,-47,11,10.75110457,3.324468085,1.02960103,0.25477707,-5.972045743,1.486486486
137,1631,950,927,922,910,916,911,911,-23,-5,-12,6,-5,0,-2.421052632,-0.539374326,-1.301518438,0.659340659,-0.545851528,0
138,177,672,928,1034,1022,881,1054,1078,256,106,-12,-141,173,24,38.0952381,11.42241379,-1.160541586,-13.7964775,19.63677639,2.277039848
139,352,1125,1027,1104,1139,1217,1269,1255,-98,77,35,78,52,-14,-8.711111111,7.497565725,3.170289855,6.848112379,4.272801972,-1.10323089
140,957,1091,1095,1142,1167,1159,1147,1135,4,47,25,-8,-12,-12,0.366636114,4.292237443,2.189141856,-0.685518423,-1.035375324,-1.046207498
141,1728,1232,1453,1442,1470,1497,1518,1511,221,-11,28,27,21,-7,17.93831169,-0.75705437,1.941747573,1.836734694,1.402805611,-0.46113307
142,665,796,801,800,920,860,877,931,5,-1,120,-60,17,54,0.628140704,-0.124843945,15,-6.52173913,1.976744186,6.157354618
143,906,948,866,951,1003,982,939,970,-82,85,52,-21,-43,31,-8.64978903,9.815242494,5.467928496,-2.093718843,-4.378818737,3.301384452
144,1384,847,813,815,686,740,825,699,-34,2,-129,54,85,-126,-4.014167651,0.24600246,-15.82822086,7.871720117,11.48648649,-15.27272727
145,1902,1083,1081,1151,1166,1173,1172,1144,-2,70,15,7,-1,-28,-0.184672207,6.475485661,1.303214596,0.600343053,-0.085251492,-2.389078498
146,71,1697,1737,1718,1743,1818,1883,1902,40,-19,25,75,65,19,2.357100766,-1.093839954,1.455180442,4.30292599,3.575357536,1.009028147
147,1119,898,859,844,876,876,902,890,-39,-15,32,0,26,-12,-4.34298441,-1.746216531,3.791469194,0,2.96803653,-1.33037694
148,1025,735,937,996,1005,1032,1001,1102,202,59,9,27,-31,101,27.4829932,6.296691569,0.903614458,2.686567164,-3.003875969,10.08991009
149,1427,939,959,953,955,1003,1042,1090,20,-6,2,48,39,48,2.129925453,-0.625651721,0.209863589,5.02617801,3.888334995,4.606525912
150,182,1091,1185,1210,1199,1289,1376,1419,94,25,-11,90,87,43,8.615948671,2.109704641,-0.909090909,7.506255213,6.749418154,3.125
151,1673,1296,1256,1291,1235,1221,1158,1088,-40,35,-56,-14,-63,-70,-3.086419753,2.786624204,-4.337722696,-1.133603239,-5.15970516,-6.044905009
152,105,1700,1661,1650,1701,1700,1737,1770,-39,-11,51,-1,37,33,-2.294117647,-0.662251656,3.090909091,-0.058788948,2.176470588,1.899827288
153,1588,1282,1243,1286,1314,1337,1426,1464,-39,43,28,23,89,38,-3.042121685,3.459372486,2.177293935,1.750380518,6.656694091,2.664796634
154,907,906,894,835,903,950,923,902,-12,-59,68,47,-27,-21,-1.324503311,-6.599552573,8.143712575,5.204872647,-2.842105263,-2.275189599
155,1457,1017,1013,1133,1054,933,1025,1006,-4,120,-79,-121,92,-19,-0.393313668,11.84600197,-6.972639011,-11.4800759,9.860664523,-1.853658537
156,129,1199,1117,1188,1287,1277,1293,1335,-82,71,99,-10,16,42,-6.839032527,6.356311549,8.333333333,-0.777000777,1.25293657,3.248259861
157,192,1386,1152,1186,1197,1295,1310,1384,-234,34,11,98,15,74,-16.88311688,2.951388889,0.927487352,8.187134503,1.158301158,5.648854962
158,1817,999,982,965,954,1015,942,924,-17,-17,-11,61,-73,-18,-1.701701702,-1.731160896,-1.139896373,6.394129979,-7.192118227,-1.910828025
159,231,1011,1058,1090,1119,1160,1236,1251,47,32,29,41,76,15,4.648862512,3.024574669,2.660550459,3.663985702,6.551724138,1.213592233
160,1369,974,860,931,897,915,983,896,-114,71,-34,18,68,-87,-11.70431211,8.255813953,-3.651987111,2.006688963,7.431693989,-8.850457782
161,1237,981,989,828,939,900,948,925,8,-161,111,-39,48,-23,0.815494393,-16.27906977,13.4057971,-4.153354633,5.333333333,-2.426160338
162,634,1479,1337,1190,1331,1387,1394,1538,-142,-147,141,56,7,144,-9.601081812,-10.9947644,11.8487395,4.207362885,0.504686373,10.32998565
163,1632,1020,1005,1035,1126,1155,1220,1241,-15,30,91,29,65,21,-1.470588235,2.985074627,8.792270531,2.575488455,5.627705628,1.721311475
164,328,837,720,731,727,776,759,767,-117,11,-4,49,-17,8,-13.97849462,1.527777778,-0.547195622,6.74002751,-2.190721649,1.054018445
165,1078,885,793,848,792,821,878,821,-92,55,-56,29,57,-57,-10.39548023,6.935687264,-6.603773585,3.661616162,6.942752741,-6.492027335
166,1313,1055,828,717,820,864,942,896,-227,-111,103,44,78,-46,-21.51658768,-13.4057971,14.36541144,5.365853659,9.027777778,-4.883227176
167,2309,1104,1095,1099,1137,1181,1232,1207,-9,4,38,44,51,-25,-0.815217391,0.365296804,3.457688808,3.869832894,4.318374259,-2.029220779
168,1575,980,919,912,933,1004,1017,1000,-61,-7,21,71,13,-17,-6.224489796,-0.761697497,2.302631579,7.609860665,1.294820717,-1.671583088
169,1639,961,924,921,905,983,1003,1029,-37,-3,-16,78,20,26,-3.850156087,-0.324675325,-1.737242128,8.61878453,2.034587996,2.59222333
170,411,1587,1682,1695,1732,1739,1754,1784,95,13,37,7,15,30,5.986137366,0.772889417,2.182890855,0.404157044,0.862564692,1.710376283
171,288,914,916,957,942,586,679,705,2,41,-15,-356,93,26,0.218818381,4.475982533,-1.567398119,-37.79193206,15.87030717,3.82916053
172,1576,1176,1167,994,1038,1057,1087,1043,-9,-173,44,19,30,-44,-0.765306122,-14.8243359,4.426559356,1.83044316,2.838221381,-4.047838086
173,1076,1239,1236,1249,1225,1250,1241,1274,-3,13,-24,25,-9,33,-0.242130751,1.051779935,-1.92153723,2.040816327,-0.72,2.65914585
174,91,1522,1485,1447,1474,1501,1548,1555,-37,-38,27,27,47,7,-2.431011827,-2.558922559,1.865929509,1.831750339,3.131245836,0.452196382
175,1201,940,909,861,907,868,898,912,-31,-48,46,-39,30,14,-3.29787234,-5.280528053,5.342624855,-4.299889746,3.456221198,1.559020045
176,404,986,1003,1037,1087,1135,1113,1207,17,34,50,48,-22,94,1.724137931,3.389830508,4.821600771,4.415823367,-1.938325991,8.445642408
177,559,1117,1094,951,1014,996,1054,1067,-23,-143,63,-18,58,13,-2.05908684,-13.07129799,6.624605678,-1.775147929,5.823293173,1.233396584
178,336,1014,1006,1196,1254,1287,1248,1227,-8,190,58,33,-39,-21,-0.788954635,18.88667992,4.849498328,2.631578947,-3.03030303,-1.682692308
179,1021,949,926,959,961,1018,1099,1091,-23,33,2,57,81,-8,-2.423603793,3.563714903,0.208550574,5.93132154,7.956777996,-0.727934486
180,1419,743,845,881,824,911,936,903,102,36,-57,87,25,-33,13.72812921,4.26035503,-6.469920545,10.55825243,2.744237102,-3.525641026
181,496,1163,1028,966,989,1014,1131,1159,-135,-62,23,25,117,28,-11.60791058,-6.031128405,2.380952381,2.527805865,11.53846154,2.475685234
182,2789,798,805,767,767,776,788,845,7,-38,0,9,12,57,0.877192982,-4.720496894,0,1.173402868,1.546391753,7.233502538
183,768,1290,1311,1400,1365,1380,1402,1410,21,89,-35,15,22,8,1.627906977,6.788710908,-2.5,1.098901099,1.594202899,0.570613409
184,809,1188,1192,1179,1218,1207,1237,1258,4,-13,39,-11,30,21,0.336700337,-1.090604027,3.307888041,-0.903119869,2.485501243,1.697655618
185,1346,979,878,873,901,935,926,964,-101,-5,28,34,-9,38,-10.31664964,-0.569476082,3.207331042,3.773584906,-0.962566845,4.103671706
186,2068,998,908,963,944,997,1069,1091,-90,55,-19,53,72,22,-9.018036072,6.057268722,-1.973001038,5.61440678,7.221664995,2.057998129
187,1927,1327,1350,1350,1335,1311,1231,1110,23,0,-15,-24,-80,-121,1.733232856,0,-1.111111111,-1.797752809,-6.102212052,-9.829406986
188,2346,921,891,886,913,925,935,916,-30,-5,27,12,10,-19,-3.25732899,-0.561167228,3.047404063,1.314348302,1.081081081,-2.032085561
189,243,1718,1786,1750,1790,1840,1800,1832,68,-36,40,50,-40,32,3.958090803,-2.015677492,2.285714286,2.793296089,-2.173913043,1.777777778
190,1541,1200,1155,1248,1431,1372,1339,1175,-45,93,183,-59,-33,-164,-3.75,8.051948052,14.66346154,-4.122990915,-2.405247813,-12.24794623
191,555,1201,1135,1137,1124,1183,1260,1366,-66,2,-13,59,77,106,-5.495420483,0.176211454,-1.143359719,5.24911032,6.50887574,8.412698413
192,612,696,743,766,850,888,917,872,47,23,84,38,29,-45,6.752873563,3.095558546,10.96605744,4.470588235,3.265765766,-4.907306434
193,543,849,889,863,877,916,896,933,40,-26,14,39,-20,37,4.711425206,-2.924634421,1.622247972,4.446978335,-2.183406114,4.129464286
194,488,1283,1221,1184,1197,1238,1222,1241,-62,-37,13,41,-16,19,-4.832424006,-3.03030303,1.097972973,3.425229741,-1.292407108,1.554828151
195,402,1514,1661,1671,1770,1779,1756,1805,147,10,99,9,-23,49,9.709379128,0.60204696,5.92459605,0.508474576,-1.292861158,2.790432802
196,1983,778,730,744,740,747,744,772,-48,14,-4,7,-3,28,-6.16966581,1.917808219,-0.537634409,0.945945946,-0.401606426,3.76344086
197,1518,1216,1110,992,992,939,1002,1015,-106,-118,0,-53,63,13,-8.717105263,-10.63063063,0,-5.342741935,6.709265176,1.29740519
198,1365,1012,1144,961,958,1260,1378,1386,132,-183,-3,302,118,8,13.04347826,-15.9965035,-0.312174818,31.52400835,9.365079365,0.580551524
199,844,1118,1156,1101,1220,1229,1273,1294,38,-55,119,9,44,21,3.398926655,-4.757785467,10.80835604,0.737704918,3.580146461,1.649646504
200,864,914,866,866,882,902,986,901,-48,0,16,20,84,-85,-5.251641138,0,1.847575058,2.267573696,9.312638581,-8.620689655
201,271,898,944,879,820,924,874,903,46,-65,-59,104,-50,29,5.122494432,-6.88559322,-6.712172924,12.68292683,-5.411255411,3.318077803
202,1466,987,987,984,1026,1042,1035,1019,0,-3,42,16,-7,-16,0,-0.303951368,4.268292683,1.559454191,-0.671785029,-1.54589372
203,433,1285,1341,1338,1305,1384,1295,1234,56,-3,-33,79,-89,-61,4.357976654,-0.223713647,-2.466367713,6.053639847,-6.430635838,-4.71042471
204,434,1355,1408,1432,1374,1481,1372,1391,53,24,-58,107,-109,19,3.911439114,1.704545455,-4.05027933,7.787481805,-7.359891965,1.38483965
205,371,1434,1278,1403,1355,1301,1363,1358,-156,125,-48,-54,62,-5,-10.87866109,9.780907668,-3.4212402,-3.985239852,4.76556495,-0.366837858
206,272,1229,1237,1306,1476,1437,1526,1475,8,69,170,-39,89,-51,0.65093572,5.578011318,13.01684533,-2.642276423,6.193458594,-3.342070773
207,1669,1329,1317,1326,1388,1469,1551,1531,-12,9,62,81,82,-20,-0.902934537,0.683371298,4.67571644,5.83573487,5.582028591,-1.289490651
208,692,923,909,917,962,1010,1045,1034,-14,8,45,48,35,-11,-1.516793066,0.880088009,4.907306434,4.98960499,3.465346535,-1.052631579
209,1111,1112,1115,1140,1173,1148,1149,1154,3,25,33,-25,1,5,0.269784173,2.242152466,2.894736842,-2.131287298,0.087108014,0.43516101
210,285,1766,1757,1764,1783,1805,1836,1891,-9,7,19,22,31,55,-0.509626274,0.398406375,1.077097506,1.233875491,1.717451524,2.995642702
211,135,1399,1427,1446,1526,1639,1794,1862,28,19,80,113,155,68,2.001429593,1.331464611,5.532503458,7.404980341,9.456985967,3.790412486
212,1783,1404,1179,1145,1184,1048,1156,1144,-225,-34,39,-136,108,-12,-16.02564103,-2.88379983,3.406113537,-11.48648649,10.30534351,-1.038062284
213,1283,1206,1138,1227,1287,1545,1536,1695,-68,89,60,258,-9,159,-5.638474295,7.820738137,4.88997555,20.04662005,-0.582524272,10.3515625
214,2732,1121,1051,1092,1112,1077,1109,1142,-70,41,20,-35,32,33,-6.244424621,3.901046622,1.831501832,-3.147482014,2.971216342,2.975653742
215,1581,1039,1208,1328,1349,1349,1368,1533,169,120,21,0,19,165,16.26564004,9.933774834,1.581325301,0,1.408450704,12.06140351
216,1234,1182,1123,1147,1186,1205,1240,1233,-59,24,39,19,35,-7,-4.991539763,2.13713268,3.400174368,1.602023609,2.904564315,-0.564516129
217,1469,1245,1281,1343,1424,1425,1514,1627,36,62,81,1,89,113,2.891566265,4.839968774,6.031273269,0.070224719,6.245614035,7.463672391
218,2738,920,899,885,879,883,879,901,-21,-14,-6,4,-4,22,-2.282608696,-1.557285873,-0.677966102,0.455062571,-0.453001133,2.502844141
219,1458,916,1040,977,947,984,971,922,124,-63,-30,37,-13,-49,13.5371179,-6.057692308,-3.07062436,3.907074974,-1.321138211,-5.046343975
220,701,949,950,976,1025,1079,1156,1200,1,26,49,54,77,44,0.105374078,2.736842105,5.020491803,5.268292683,7.136237257,3.806228374
221,1776,1138,928,1050,946,959,1046,974,-210,122,-104,13,87,-72,-18.45342707,13.14655172,-9.904761905,1.374207188,9.071949948,-6.883365201
222,408,1250,1323,1362,1243,1379,1220,1094,73,39,-119,136,-159,-126,5.84,2.947845805,-8.737151248,10.94127112,-11.53009427,-10.32786885
223,589,1274,1364,1399,1367,1403,1310,1261,90,35,-32,36,-93,-49,7.064364207,2.565982405,-2.287348106,2.633504023,-6.628652887,-3.740458015
224,834,965,969,1007,931,956,1013,994,4,38,-76,25,57,-19,0.414507772,3.921568627,-7.547169811,2.68528464,5.962343096,-1.875616979
225,1248,1243,1237,1235,1259,1318,1357,1447,-6,-2,24,59,39,90,-0.482703138,-0.161681487,1.943319838,4.686258936,2.959028832,6.632277082
226,2065,701,707,770,751,723,727,693,6,63,-19,-28,4,-34,0.855920114,8.910891089,-2.467532468,-3.728362184,0.553250346,-4.676753783
227,820,926,1038,1017,1056,1060,1085,1080,112,-21,39,4,25,-5,12.0950324,-2.023121387,3.83480826,0.378787879,2.358490566,-0.460829493
228,617,799,867,854,929,905,942,937,68,-13,75,-24,37,-5,8.510638298,-1.499423299,8.782201405,-2.583423036,4.08839779,-0.530785563
229,554,846,835,873,881,799,898,962,-11,38,8,-82,99,64,-1.300236407,4.550898204,0.916380298,-9.307604994,12.39048811,7.126948775
230,1525,1188,1158,1161,1109,1111,1115,1136,-30,3,-52,2,4,21,-2.525252525,0.259067358,-4.478897502,0.180342651,0.360036004,1.883408072
231,2785,866,883,846,926,981,986,974,17,-37,80,55,5,-12,1.963048499,-4.190260476,9.456264775,5.939524838,0.509683996,-1.21703854
232,190,1547,1596,1582,1594,1629,1595,1585,49,-14,12,35,-34,-10,3.167420814,-0.877192982,0.758533502,2.195734003,-2.087170043,-0.626959248
233,1413,1270,1317,1242,1319,1245,1364,1383,47,-75,77,-74,119,19,3.700787402,-5.69476082,6.199677939,-5.610310842,9.558232932,1.392961877
234,94,1826,1850,1884,1967,1974,2015,2016,24,34,83,7,41,1,1.314348302,1.837837838,4.40552017,0.355871886,2.077001013,0.049627792
235,144,1308,1345,1341,1396,1431,1428,1413,37,-4,55,35,-3,-15,2.828746177,-0.29739777,4.101416853,2.507163324,-0.209643606,-1.050420168
236,2131,889,964,961,980,1085,1150,1094,75,-3,19,105,65,-56,8.436445444,-0.31120332,1.97710718,10.71428571,5.99078341,-4.869565217
237,2901,1039,1043,1020,1129,1109,1152,1058,4,-23,109,-20,43,-94,0.384985563,-2.205177373,10.68627451,-1.771479185,3.877366997,-8.159722222
238,704,1080,890,982,866,872,907,892,-190,92,-116,6,35,-15,-17.59259259,10.33707865,-11.81262729,0.692840647,4.013761468,-1.653803749
239,564,1256,1275,1290,1336,1340,1393,1429,19,15,46,4,53,36,1.512738854,1.176470588,3.565891473,0.299401198,3.955223881,2.584350323
240,1934,1081,1049,1071,1121,1120,1105,1093,-32,22,50,-1,-15,-12,-2.960222017,2.097235462,4.66853408,-0.089206066,-1.339285714,-1.085972851
241,460,869,919,855,843,856,849,880,50,-64,-12,13,-7,31,5.753739931,-6.964091404,-1.403508772,1.542111507,-0.817757009,3.651354535
242,1410,850,795,827,841,852,829,891,-55,32,14,11,-23,62,-6.470588235,4.025157233,1.69286578,1.307966706,-2.699530516,7.478890229
243,847,1148,1092,1129,1095,1045,1115,1189,-56,37,-34,-50,70,74,-4.87804878,3.388278388,-3.011514615,-4.566210046,6.698564593,6.6367713
244,2469,947,1133,1046,1057,984,983,974,186,-87,11,-73,-1,-9,19.64097149,-7.678729038,1.051625239,-6.906338694,-0.101626016,-0.915564598
245,1303,1009,834,868,919,1047,1027,1108,-175,34,51,128,-20,81,-17.34390486,4.076738609,5.875576037,13.92818281,-1.910219675,7.887049659
246,125,1295,1514,1476,1627,1726,1895,1979,219,-38,151,99,169,84,16.91119691,-2.50990753,10.2303523,6.084818685,9.791425261,4.432717678
247,1434,1150,1143,1110,1235,1245,1298,1375,-7,-33,125,10,53,77,-0.608695652,-2.887139108,11.26126126,0.809716599,4.257028112,5.93220339
248,1723,991,839,820,834,816,857,837,-152,-19,14,-18,41,-20,-15.33804238,-2.264600715,1.707317073,-2.158273381,5.024509804,-2.333722287
249,744,1074,1087,1066,977,961,1008,983,13,-21,-89,-16,47,-25,1.210428305,-1.931922723,-8.348968105,-1.637666325,4.890738814,-2.48015873
250,695,1004,951,1092,1070,941,995,1011,-53,141,-22,-129,54,16,-5.278884462,14.82649842,-2.014652015,-12.05607477,5.738575983,1.608040201
251,1347,895,771,771,797,939,966,1053,-124,0,26,142,27,87,-13.8547486,0,3.372243839,17.81681305,2.875399361,9.00621118
252,1661,1000,1022,955,976,1016,1049,1072,22,-67,21,40,33,23,2.2,-6.555772994,2.19895288,4.098360656,3.248031496,2.192564347
253,10,1198,1168,1159,1178,1195,1219,1249,-30,-9,19,17,24,30,-2.504173623,-0.770547945,1.639344262,1.443123939,2.008368201,2.461033634
254,292,826,851,770,724,766,751,818,25,-81,-46,42,-15,67,3.026634383,-9.518213866,-5.974025974,5.801104972,-1.958224543,8.921438083
255,113,997,1296,1365,1416,1488,1600,1694,299,69,51,72,112,94,29.98996991,5.324074074,3.736263736,5.084745763,7.52688172,5.875
256,1336,1087,950,967,973,998,1108,1112,-137,17,6,25,110,4,-12.60349586,1.789473684,0.620475698,2.569373073,11.02204409,0.36101083
257,2650,994,1110,923,925,1050,1051,922,116,-187,2,125,1,-129,11.67002012,-16.84684685,0.216684724,13.51351351,0.095238095,-12.27402474
258,1014,1508,1552,1654,1594,1717,1675,1732,44,102,-60,123,-42,57,2.917771883,6.572164948,-3.627569528,7.716436637,-2.446126966,3.402985075
259,1260,1132,1159,1189,1222,1220,1248,1267,27,30,33,-2,28,19,2.385159011,2.588438309,2.775441548,-0.163666121,2.295081967,1.522435897
260,1768,850,800,783,859,876,847,887,-50,-17,76,17,-29,40,-5.882352941,-2.125,9.706257982,1.979045402,-3.310502283,4.722550177
261,2389,689,785,898,873,972,949,856,96,113,-25,99,-23,-93,13.93323657,14.39490446,-2.783964365,11.34020619,-2.366255144,-9.799789252
262,1246,942,1096,1090,1133,1211,1263,1312,154,-6,43,78,52,49,16.34819533,-0.547445255,3.944954128,6.884377758,4.293971924,3.879651623
263,2347,1093,1062,1069,1142,1118,1173,1118,-31,7,73,-24,55,-55,-2.836230558,0.65913371,6.828811974,-2.101576182,4.919499106,-4.688832055
264,1236,856,856,850,850,850,849,890,0,-6,0,0,-1,41,0,-0.700934579,0,0,-0.117647059,4.829210836
265,1087,1320,1315,1362,1397,1484,1654,1739,-5,47,35,87,170,85,-0.378787879,3.574144487,2.569750367,6.227630637,11.45552561,5.139056832
266,430,997,980,1073,989,1041,980,973,-17,93,-84,52,-61,-7,-1.705115346,9.489795918,-7.828518173,5.257836198,-5.85975024,-0.714285714
267,835,874,980,949,996,1046,1030,1041,106,-31,47,50,-16,11,12.12814645,-3.163265306,4.952581665,5.020080321,-1.529636711,1.067961165
268,214,1199,1200,1109,1322,1321,1324,1351,1,-91,213,-1,3,27,0.083402836,-7.583333333,19.20649234,-0.075642965,0.227100681,2.039274924
269,172,964,1145,1155,1161,1231,1202,1188,181,10,6,70,-29,-14,18.77593361,0.873362445,0.519480519,6.029285099,-2.355808286,-1.164725458
270,1635,1227,1193,1203,1173,1116,1173,1166,-34,10,-30,-57,57,-7,-2.770986145,0.838222967,-2.493765586,-4.859335038,5.107526882,-0.596760443
271,1985,850,798,795,812,840,844,916,-52,-3,17,28,4,72,-6.117647059,-0.37593985,2.13836478,3.448275862,0.476190476,8.530805687
272,429,1530,1565,1642,1778,1747,1578,1603,35,77,136,-31,-169,25,2.287581699,4.920127796,8.282582217,-1.743532058,-9.673726388,1.584283904
273,2364,657,702,810,780,840,701,687,45,108,-30,60,-139,-14,6.849315068,15.38461538,-3.703703704,7.692307692,-16.54761905,-1.997146933
274,1179,1311,1290,1282,1322,1367,1452,1496,-21,-8,40,45,85,44,-1.601830664,-0.620155039,3.120124805,3.403933434,6.217995611,3.03030303
275,305,995,1065,954,968,920,893,870,70,-111,14,-48,-27,-23,7.035175879,-10.42253521,1.467505241,-4.958677686,-2.934782609,-2.575587906
276,300,1444,1592,1427,1537,1578,1581,1834,148,-165,110,41,3,253,10.24930748,-10.36432161,7.708479327,2.667534157,0.190114068,16.00253004
277,594,920,955,954,945,885,883,886,35,-1,-9,-60,-2,3,3.804347826,-0.104712042,-0.943396226,-6.349206349,-0.225988701,0.339750849
278,1514,949,907,955,956,999,1022,1079,-42,48,1,43,23,57,-4.425711275,5.292171996,0.104712042,4.49790795,2.302302302,5.577299413
279,561,948,897,815,868,819,889,860,-51,-82,53,-49,70,-29,-5.379746835,-9.141583055,6.503067485,-5.64516129,8.547008547,-3.262092238
280,1418,996,938,892,883,764,763,888,-58,-46,-9,-119,-1,125,-5.823293173,-4.904051173,-1.00896861,-13.47678369,-0.130890052,16.38269987
281,1997,1054,1133,958,1022,1080,1148,1062,79,-175,64,58,68,-86,7.495256167,-15.44571933,6.680584551,5.675146771,6.296296296,-7.491289199
282,703,984,1059,1053,1053,1048,1094,1135,75,-6,0,-5,46,41,7.62195122,-0.566572238,0,-0.474833808,4.389312977,3.747714808
283,54,1633,1627,1684,1748,1838,1896,1944,-6,57,64,90,58,48,-0.367421923,3.503380455,3.800475059,5.148741419,3.155603917,2.53164557
284,959,1161,1180,1162,1185,1182,1198,1187,19,-18,23,-3,16,-11,1.636520241,-1.525423729,1.979345955,-0.253164557,1.353637902,-0.918196995
285,2494,1240,1206,1223,1309,1359,1416,1380,-34,17,86,50,57,-36,-2.741935484,1.409618574,7.031888798,3.819709702,4.194260486,-2.542372881
286,1451,1000,978,997,1024,1119,1155,1091,-22,19,27,95,36,-64,-2.2,1.942740286,2.708124373,9.27734375,3.217158177,-5.541125541
287,1326,1200,1216,1117,1189,1209,1249,1234,16,-99,72,20,40,-15,1.333333333,-8.141447368,6.445837064,1.682085786,3.308519438,-1.200960769
288,507,1594,1487,1441,1435,1477,1592,1540,-107,-46,-6,42,115,-52,-6.712672522,-3.093476799,-0.416377516,2.926829268,7.78605281,-3.266331658
289,599,1075,1055,1064,1230,1209,1312,1486,-20,9,166,-21,103,174,-1.860465116,0.853080569,15.60150376,-1.707317073,8.519437552,13.26219512
290,482,1090,1051,1114,1067,1146,1116,1130,-39,63,-47,79,-30,14,-3.577981651,5.994291151,-4.219030521,7.40393627,-2.617801047,1.254480287
291,347,766,791,821,833,846,879,860,25,30,12,13,33,-19,3.263707572,3.792667509,1.461632156,1.56062425,3.90070922,-2.161547213
292,898,1348,1364,1388,1280,1306,1392,1380,16,24,-108,26,86,-12,1.18694362,1.759530792,-7.780979827,2.03125,6.584992343,-0.862068966
293,1351,1403,1287,1437,1507,1545,1661,1696,-116,150,70,38,116,35,-8.267997149,11.65501166,4.871259569,2.521566025,7.508090615,2.107164359
294,318,786,745,744,771,740,729,697,-41,-1,27,-31,-11,-32,-5.216284987,-0.134228188,3.629032258,-4.02075227,-1.486486486,-4.38957476
295,2400,969,953,1025,1049,1057,1108,1136,-16,72,24,8,51,28,-1.651186791,7.555089192,2.341463415,0.762631077,4.824976348,2.527075812
296,27,1893,2004,2004,2107,2310,2479,2641,111,0,103,203,169,162,5.863708399,0,5.139720559,9.634551495,7.316017316,6.534893102
297,899,772,782,835,834,863,843,819,10,53,-1,29,-20,-24,1.295336788,6.777493606,-0.119760479,3.477218225,-2.317497103,-2.846975089
298,1900,917,921,928,919,917,890,908,4,7,-9,-2,-27,18,0.436205016,0.760043431,-0.969827586,-0.217627856,-2.94438386,2.02247191
299,1156,1585,1492,1521,1599,1658,1663,1672,-93,29,78,59,5,9,-5.867507886,1.943699732,5.128205128,3.689806129,0.301568154,0.541190619
300,1629,1141,1174,1147,1187,1181,1237,1289,33,-27,40,-6,56,52,2.892199825,-2.299829642,3.487358326,-0.50547599,4.741744285,4.203718674
301,1697,995,998,1183,1175,1064,1094,1202,3,185,-8,-111,30,108,0.301507538,18.53707415,-0.67624683,-9.446808511,2.819548872,9.87202925
302,508,887,917,1037,938,996,1075,1218,30,120,-99,58,79,143,3.382187148,13.08615049,-9.546769527,6.18336887,7.931726908,13.30232558
303,2187,778,764,785,838,841,828,860,-14,21,53,3,-13,32,-1.799485861,2.748691099,6.751592357,0.357995227,-1.545778835,3.8647343
304,600,1310,1378,1403,1371,1467,1358,1374,68,25,-32,96,-109,16,5.190839695,1.814223512,-2.2808268,7.002188184,-7.430129516,1.17820324
305,1422,1015,866,888,890,889,867,885,-149,22,2,-1,-22,18,-14.67980296,2.540415704,0.225225225,-0.112359551,-2.474690664,2.076124567
306,727,780,835,847,858,895,924,922,55,12,11,37,29,-2,7.051282051,1.437125749,1.298701299,4.312354312,3.240223464,-0.216450216
307,1124,698,694,736,781,764,844,734,-4,42,45,-17,80,-110,-0.573065903,6.051873199,6.114130435,-2.176696543,10.47120419,-13.03317536
308,1325,1200,1204,1185,1167,1306,1301,1375,4,-19,-18,139,-5,74,0.333333333,-1.57807309,-1.518987342,11.9108826,-0.382848392,5.68793236
309,362,1105,1093,1077,1154,1185,1259,1312,-12,-16,77,31,74,53,-1.085972851,-1.463860933,7.149489322,2.686308492,6.244725738,4.20969023
310,385,799,833,923,946,1048,1028,1053,34,90,23,102,-20,25,4.255319149,10.80432173,2.491874323,10.78224101,-1.908396947,2.431906615
311,2958,1152,1124,1097,1158,1147,1078,1042,-28,-27,61,-11,-69,-36,-2.430555556,-2.402135231,5.560619872,-0.949913644,-6.015693112,-3.339517625
312,359,1064,1049,1024,1013,1048,1026,1000,-15,-25,-11,35,-22,-26,-1.409774436,-2.383222116,-1.07421875,3.455083909,-2.099236641,-2.53411306
313,515,796,802,858,870,799,798,897,6,56,12,-71,-1,99,0.753768844,6.982543641,1.398601399,-8.16091954,-0.125156446,12.40601504
314,1623,713,724,796,799,767,740,709,11,72,3,-32,-27,-31,1.542776999,9.944751381,0.376884422,-4.005006258,-3.520208605,-4.189189189
315,651,750,803,796,797,807,812,836,53,-7,1,10,5,24,7.066666667,-0.871731009,0.125628141,1.254705144,0.619578686,2.955665025
316,409,1158,1107,1205,1094,1121,1051,1035,-51,98,-111,27,-70,-16,-4.404145078,8.852755194,-9.211618257,2.468007313,-6.244424621,-1.522359657
317,473,757,779,793,832,881,916,929,22,14,39,49,35,13,2.906208719,1.797175866,4.918032787,5.889423077,3.972758229,1.419213974
318,2056,926,933,936,911,922,881,890,7,3,-25,11,-41,9,0.755939525,0.321543408,-2.670940171,1.207464325,-4.446854664,1.021566402
319,588,770,801,881,923,845,849,845,31,80,42,-78,4,-4,4.025974026,9.987515605,4.767309875,-8.450704225,0.473372781,-0.471142521
320,904,890,871,851,997,1065,1209,1387,-19,-20,146,68,144,178,-2.134831461,-2.296211251,17.15628672,6.820461384,13.52112676,14.7229115
321,2782,955,852,975,926,878,930,1017,-103,123,-49,-48,52,87,-10.78534031,14.43661972,-5.025641026,-5.183585313,5.922551253,9.35483871
322,622,1252,1451,1406,1483,1500,1533,1554,199,-45,77,17,33,21,15.89456869,-3.101309442,5.476529161,1.146325017,2.2,1.369863014
323,142,908,872,871,878,871,864,805,-36,-1,7,-7,-7,-59,-3.964757709,-0.114678899,0.803673938,-0.797266515,-0.803673938,-6.828703704
324,267,1385,1269,1288,1270,1238,1200,1229,-116,19,-18,-32,-38,29,-8.375451264,1.497241923,-1.397515528,-2.519685039,-3.069466882,2.416666667
325,184,1329,1164,1234,1238,1324,1377,1352,-165,70,4,86,53,-25,-12.41534989,6.013745704,0.324149109,6.946688207,4.003021148,-1.815541031
326,2471,1168,1181,1184,1196,1205,1192,1218,13,3,12,9,-13,26,1.113013699,0.254022015,1.013513514,0.752508361,-1.078838174,2.181208054
327,867,1278,1251,1224,1226,1296,1319,1364,-27,-27,2,70,23,45,-2.112676056,-2.158273381,0.163398693,5.709624796,1.774691358,3.411675512
328,2045,825,817,838,1025,1028,1101,995,-8,21,187,3,73,-106,-0.96969697,2.570379437,22.3150358,0.292682927,7.101167315,-9.627611262
329,22,1043,1060,1046,1098,1139,1128,1144,17,-14,52,41,-11,16,1.62991371,-1.320754717,4.971319312,3.734061931,-0.965759438,1.418439716
330,1911,962,943,930,967,948,956,992,-19,-13,37,-19,8,36,-1.975051975,-1.378579003,3.978494624,-1.96483971,0.843881857,3.765690377
331,121,1402,1476,1485,1548,1582,1577,1637,74,9,63,34,-5,60,5.278174037,0.609756098,4.242424242,2.196382429,-0.316055626,3.804692454
332,591,858,893,962,864,856,872,887,35,69,-98,-8,16,15,4.079254079,7.726763718,-10.18711019,-0.925925926,1.869158879,1.720183486
333,491,1200,1225,1397,1459,1478,1520,1553,25,172,62,19,42,33,2.083333333,14.04081633,4.438081603,1.302261823,2.841677943,2.171052632
334,1906,650,753,722,744,739,810,806,103,-31,22,-5,71,-4,15.84615385,-4.11686587,3.047091413,-0.672043011,9.607577808,-0.49382716
335,6,1206,1181,1207,1255,1294,1350,1439,-25,26,48,39,56,89,-2.072968491,2.201524132,3.976801988,3.107569721,4.327666151,6.592592593
336,660,781,849,811,851,848,805,789,68,-38,40,-3,-43,-16,8.706786172,-4.475853946,4.932182491,-0.352526439,-5.070754717,-1.98757764
337,756,1463,1431,1426,1370,1393,1429,1456,-32,-5,-56,23,36,27,-2.187286398,-0.34940601,-3.927068724,1.678832117,2.584350323,1.88943317
338,568,917,897,928,959,1042,1101,1025,-20,31,31,83,59,-76,-2.181025082,3.455964326,3.340517241,8.654848801,5.6621881,-6.902815622
339,167,1148,1142,1105,1153,1197,1228,1210,-6,-37,48,44,31,-18,-0.522648084,-3.239929947,4.343891403,3.81613183,2.589807853,-1.465798046
340,251,868,884,844,864,843,893,880,16,-40,20,-21,50,-13,1.843317972,-4.524886878,2.369668246,-2.430555556,5.931198102,-1.455767077
341,69,1168,1185,1191,1285,1363,1489,1554,17,6,94,78,126,65,1.455479452,0.506329114,7.892527288,6.070038911,9.244314013,4.36534587
342,684,998,1063,1111,1086,1148,1165,1180,65,48,-25,62,17,15,6.513026052,4.515522107,-2.250225023,5.709023941,1.480836237,1.287553648
343,1368,851,897,895,889,871,919,946,46,-2,-6,-18,48,27,5.405405405,-0.22296544,-0.670391061,-2.024746907,5.510907003,2.937976061
344,1830,1231,1240,1203,1235,1252,1305,1376,9,-37,32,17,53,71,0.731112916,-2.983870968,2.660016625,1.376518219,4.233226837,5.440613027
345,1591,962,888,880,971,971,1020,1061,-74,-8,91,0,49,41,-7.692307692,-0.900900901,10.34090909,0,5.046343975,4.019607843
346,1674,995,981,995,1077,1110,1149,1240,-14,14,82,33,39,91,-1.407035176,1.427115189,8.24120603,3.064066852,3.513513514,7.919930374
347,2241,1068,1046,1053,1153,1189,1246,1218,-22,7,100,36,57,-28,-2.059925094,0.669216061,9.496676163,3.122289679,4.793944491,-2.247191011
348,1357,1457,1296,1367,1294,1377,1320,1298,-161,71,-73,83,-57,-22,-11.05010295,5.478395062,-5.340160936,6.414219474,-4.139433551,-1.666666667
349,256,1105,1181,1155,1229,1275,1273,1304,76,-26,74,46,-2,31,6.877828054,-2.201524132,6.406926407,3.742880391,-0.156862745,2.435192459
350,593,1125,1071,1040,1085,1125,1123,1155,-54,-31,45,40,-2,32,-4.8,-2.89449113,4.326923077,3.686635945,-0.177777778,2.84951024
351,1095,983,902,868,898,1002,978,922,-81,-34,30,104,-24,-56,-8.240081384,-3.76940133,3.456221198,11.58129176,-2.395209581,-5.72597137
352,1789,965,908,897,978,998,995,993,-57,-11,81,20,-3,-2,-5.906735751,-1.211453744,9.030100334,2.044989775,-0.300601202,-0.201005025
353,1178,1102,1098,1067,1087,1126,1181,1258,-4,-31,20,39,55,77,-0.362976407,-2.823315118,1.874414246,3.587856486,4.884547069,6.519898391
354,1333,867,779,681,774,721,777,820,-88,-98,93,-53,56,43,-10.14994233,-12.58023107,13.65638767,-6.84754522,7.766990291,5.534105534
355,609,1338,1415,1474,1460,1504,1419,1423,77,59,-14,44,-85,4,5.754857997,4.169611307,-0.949796472,3.01369863,-5.651595745,0.281888654
356,237,1538,1733,1726,1859,1978,2065,2145,195,-7,133,119,87,80,12.67880364,-0.403923832,7.705677868,6.401291017,4.398382204,3.87409201
357,679,1000,990,1073,984,1149,1140,1044,-10,83,-89,165,-9,-96,-1,8.383838384,-8.294501398,16.76829268,-0.783289817,-8.421052632
358,79,1352,1439,1475,1434,1474,1507,1540,87,36,-41,40,33,33,6.434911243,2.501737318,-2.779661017,2.789400279,2.23880597,2.189781022
359,787,1096,1113,1108,1139,1140,1186,1236,17,-5,31,1,46,50,1.551094891,-0.449236298,2.797833935,0.087796313,4.035087719,4.215851602
360,1642,1030,860,887,856,810,901,892,-170,27,-31,-46,91,-9,-16.50485437,3.139534884,-3.494926719,-5.373831776,11.2345679,-0.998890122
361,2689,984,957,977,1013,1036,1085,1115,-27,20,36,23,49,30,-2.743902439,2.089864159,3.684749232,2.270483712,4.72972973,2.764976959
362,65,1500,1504,1569,1635,1715,1748,1802,4,65,66,80,33,54,0.266666667,4.321808511,4.206500956,4.892966361,1.924198251,3.089244851
363,76,1322,1364,1446,1600,1763,1946,2001,42,82,154,163,183,55,3.177004539,6.011730205,10.65006916,10.1875,10.38003403,2.82631038
364,690,900,803,841,884,936,948,926,-97,38,43,52,12,-22,-10.77777778,4.732254047,5.112960761,5.882352941,1.282051282,-2.320675105
365,266,1054,1061,1136,1286,1489,1608,1680,7,75,150,203,119,72,0.664136622,7.068803016,13.20422535,15.78538103,7.9919409,4.47761194
366,3031,1094,943,922,935,1038,989,965,-151,-21,13,103,-49,-24,-13.80255941,-2.226935313,1.409978308,11.01604278,-4.72061657,-2.42669363
367,1868,811,941,969,893,924,877,888,130,28,-76,31,-47,11,16.02959309,2.975557917,-7.843137255,3.471444569,-5.086580087,1.254275941
368,597,933,933,940,957,982,1022,1100,0,7,17,25,40,78,0,0.750267953,1.808510638,2.612330199,4.073319756,7.632093933
369,2875,811,817,835,879,963,990,966,6,18,44,84,27,-24,0.739827374,2.203182375,5.269461078,9.556313993,2.803738318,-2.424242424
370,1757,1089,1069,1116,1173,1137,1152,1140,-20,47,57,-36,15,-12,-1.836547291,4.396632367,5.107526882,-3.069053708,1.319261214,-1.041666667
371,75,2228,2364,2408,2509,2474,2560,2593,136,44,101,-35,86,33,6.104129264,1.861252115,4.194352159,-1.394978079,3.476151981,1.2890625
372,2652,924,928,908,987,913,879,806,4,-20,79,-74,-34,-73,0.432900433,-2.155172414,8.700440529,-7.497467072,-3.723986857,-8.304891923
373,2492,916,914,925,918,914,933,945,-2,11,-7,-4,19,12,-0.218340611,1.203501094,-0.756756757,-0.435729847,2.078774617,1.286173633
374,923,1121,1122,1176,1166,1221,1265,1340,1,54,-10,55,44,75,0.089206066,4.812834225,-0.850340136,4.716981132,3.603603604,5.928853755
375,1646,1048,999,1002,1035,1070,1108,1131,-49,3,33,35,38,23,-4.675572519,0.3003003,3.293413174,3.381642512,3.551401869,2.075812274
376,1251,987,1014,985,1000,973,971,977,27,-29,15,-27,-2,6,2.73556231,-2.859960552,1.52284264,-2.7,-0.205549846,0.61791967
377,2888,745,791,815,830,920,865,845,46,24,15,90,-55,-20,6.174496644,3.034134008,1.840490798,10.84337349,-5.97826087,-2.312138728
378,816,1191,1540,1414,1380,1256,1323,1268,349,-126,-34,-124,67,-55,29.30310663,-8.181818182,-2.404526167,-8.985507246,5.334394904,-4.157218443
379,774,1230,1269,1350,1198,1242,1335,1303,39,81,-152,44,93,-32,3.170731707,6.382978723,-11.25925926,3.67278798,7.487922705,-2.397003745
380,296,1167,1239,1273,1338,1370,1423,1442,72,34,65,32,53,19,6.16966581,2.744148507,5.106048704,2.391629297,3.868613139,1.335207309
381,1374,984,958,948,680,727,766,767,-26,-10,-268,47,39,1,-2.642276423,-1.043841336,-28.27004219,6.911764706,5.364511692,0.130548303
382,158,1765,1965,2057,2151,2377,2418,2427,200,92,94,226,41,9,11.33144476,4.681933842,4.569761789,10.50674105,1.724863273,0.372208437
383,1316,1102,1076,1038,1047,1058,1082,1134,-26,-38,9,11,24,52,-2.359346642,-3.531598513,0.867052023,1.050620821,2.268431002,4.805914972
384,1865,1352,1326,1280,1360,1238,1218,1245,-26,-46,80,-122,-20,27,-1.923076923,-3.46907994,6.25,-8.970588235,-1.615508885,2.216748768
385,1344,1200,1087,1092,1171,1252,1348,1352,-113,5,79,81,96,4,-9.416666667,0.459981601,7.234432234,6.917164816,7.667731629,0.296735905
386,89,1176,1193,1199,1231,1255,1267,1300,17,6,32,24,12,33,1.445578231,0.50293378,2.668890742,1.949634444,0.956175299,2.604577743
387,616,1401,1364,1318,1253,1551,1579,1698,-37,-46,-65,298,28,119,-2.640970735,-3.372434018,-4.931714719,23.78292099,1.805286912,7.536415453
388,349,859,884,878,828,860,890,981,25,-6,-50,32,30,91,2.910360885,-0.678733032,-5.69476082,3.8647343,3.488372093,10.2247191
389,1169,1686,1713,1724,1801,1827,1894,1924,27,11,77,26,67,30,1.601423488,0.642148278,4.466357309,1.443642421,3.667214012,1.583949314
390,393,1151,994,1068,1126,1100,1098,1107,-157,74,58,-26,-2,9,-13.64031277,7.444668008,5.43071161,-2.309058615,-0.181818182,0.819672131
391,1578,859,1010,1129,1152,1082,1055,1136,151,119,23,-70,-27,81,17.57857974,11.78217822,2.037201063,-6.076388889,-2.495378928,7.677725118
392,539,840,818,822,820,815,803,834,-22,4,-2,-5,-12,31,-2.619047619,0.488997555,-0.243309002,-0.609756098,-1.472392638,3.860523039
393,1232,1164,1146,1176,1197,1246,1276,1331,-18,30,21,49,30,55,-1.546391753,2.617801047,1.785714286,4.093567251,2.407704655,4.310344828
394,153,1691,1681,1770,1699,1818,1882,1919,-10,89,-71,119,64,37,-0.591366056,5.294467579,-4.011299435,7.004120071,3.520352035,1.965993624
395,1172,1042,1063,1081,1124,1137,1170,1190,21,18,43,13,33,20,2.015355086,1.69332079,3.977798335,1.15658363,2.90237467,1.709401709
396,2173,830,848,831,848,717,635,711,18,-17,17,-131,-82,76,2.168674699,-2.004716981,2.045728039,-15.44811321,-11.43654114,11.96850394
397,577,2776,2921,2370,2637,2867,3334,3564,145,-551,267,230,467,230,5.223342939,-18.86340294,11.26582278,8.722032613,16.28880363,6.898620276
398,1880,1053,1037,1052,1125,1115,1088,1010,-16,15,73,-10,-27,-78,-1.519468186,1.446480231,6.939163498,-0.888888889,-2.421524664,-7.169117647
399,1509,928,1095,997,973,989,1091,1141,167,-98,-24,16,102,50,17.99568966,-8.949771689,-2.407221665,1.644398767,10.31344793,4.582951421
400,824,942,1017,898,988,1052,1022,1069,75,-119,90,64,-30,47,7.961783439,-11.70108161,10.02227171,6.477732794,-2.851711027,4.598825832
401,1521,1134,1170,1171,1225,1236,1284,1219,36,1,54,11,48,-65,3.174603175,0.085470085,4.611443211,0.897959184,3.883495146,-5.062305296
402,229,1683,1530,1583,1622,1715,1779,1915,-153,53,39,93,64,136,-9.090909091,3.464052288,2.463676563,5.733662145,3.731778426,7.644744238
403,72,1196,1235,1228,1273,1310,1349,1405,39,-7,45,37,39,56,3.260869565,-0.566801619,3.664495114,2.906520031,2.977099237,4.151223128
404,1175,1086,1067,1017,1022,1016,1043,997,-19,-50,5,-6,27,-46,-1.749539595,-4.686035614,0.491642085,-0.587084149,2.657480315,-4.410354746
405,875,1530,1499,1630,1759,1977,2199,2561,-31,131,129,218,222,362,-2.026143791,8.73915944,7.914110429,12.39340534,11.22913505,16.46202819
406,1863,949,914,925,970,943,886,942,-35,11,45,-27,-57,56,-3.688092729,1.203501094,4.864864865,-2.783505155,-6.044538706,6.320541761
407,606,1202,1183,1225,1245,1496,1471,1393,-19,42,20,251,-25,-78,-1.580698835,3.550295858,1.632653061,20.16064257,-1.671122995,-5.302515296
408,1747,967,1067,1095,1128,1194,1107,1166,100,28,33,66,-87,59,10.34126163,2.624179944,3.01369863,5.85106383,-7.286432161,5.329719964
409,280,1233,1260,1252,1309,1351,1399,1502,27,-8,57,42,48,103,2.189781022,-0.634920635,4.552715655,3.20855615,3.55292376,7.362401716
410,436,1007,939,929,1004,1100,946,965,-68,-10,75,96,-154,19,-6.752730884,-1.064962726,8.073196986,9.561752988,-14,2.00845666
411,2222,908,882,887,881,882,858,872,-26,5,-6,1,-24,14,-2.863436123,0.566893424,-0.67643743,0.113507378,-2.721088435,1.631701632
412,1634,1236,1201,1165,1203,1238,1247,1283,-35,-36,38,35,9,36,-2.83171521,-2.997502082,3.261802575,2.909393184,0.726978998,2.886928629
413,37,1109,1207,1171,1214,1212,1342,1314,98,-36,43,-2,130,-28,8.836789901,-2.982601491,3.672075149,-0.164744646,10.72607261,-2.086438152
414,447,1100,1000,1020,1078,1126,1141,1116,-100,20,58,48,15,-25,-9.090909091,2,5.68627451,4.452690167,1.332149201,-2.191060473
415,162,1143,1106,946,979,1032,1002,1034,-37,-160,33,53,-30,32,-3.237095363,-14.46654611,3.488372093,5.413687436,-2.906976744,3.193612774
416,1217,909,866,895,923,987,993,1013,-43,29,28,64,6,20,-4.730473047,3.348729792,3.12849162,6.933911159,0.607902736,2.014098691
417,56,1785,1767,1751,1819,1903,2078,2278,-18,-16,68,84,175,200,-1.008403361,-0.90548953,3.883495146,4.617921935,9.196006306,9.624639076
418,53,2026,1816,1505,1699,1693,1957,1911,-210,-311,194,-6,264,-46,-10.36525173,-17.12555066,12.89036545,-0.353148911,15.59362079,-2.350536536
419,1055,1177,1189,1224,1247,1267,1249,1215,12,35,23,20,-18,-34,1.019541206,2.943650126,1.879084967,1.603849238,-1.420678769,-2.722177742
420,358,886,866,799,865,864,758,863,-20,-67,66,-1,-106,105,-2.257336343,-7.736720554,8.260325407,-0.115606936,-12.26851852,13.85224274
421,2344,931,944,959,951,960,978,1003,13,15,-8,9,18,25,1.396348013,1.588983051,-0.834202294,0.94637224,1.875,2.556237219
422,884,2122,2213,2251,2472,2387,2400,2451,91,38,221,-85,13,51,4.288407163,1.717126073,9.817858729,-3.438511327,0.544616674,2.125
423,26,2250,2317,2409,2434,2479,2471,2498,67,92,25,45,-8,27,2.977777778,3.970651705,1.03777501,1.848808546,-0.32271077,1.09267503
424,38,2276,2340,2299,2412,2451,2479,2435,64,-41,113,39,28,-44,2.811950791,-1.752136752,4.915180513,1.616915423,1.142390861,-1.774909238
425,286,1200,1200,1216,1242,1332,1324,1341,0,16,26,90,-8,17,0,1.333333333,2.138157895,7.246376812,-0.600600601,1.283987915
426,1040,2478,2522,2847,2773,3010,2881,2952,44,325,-74,237,-129,71,1.775625504,12.88659794,-2.599227257,8.546700325,-4.285714286,2.464422076
427,2262,1058,1070,1071,1068,1099,1112,1127,12,1,-3,31,13,15,1.134215501,0.093457944,-0.280112045,2.902621723,1.18289354,1.348920863
428,1816,1125,1041,1016,1095,1082,1147,1280,-84,-25,79,-13,65,133,-7.466666667,-2.401536984,7.775590551,-1.187214612,6.007393715,11.59546643
429,1683,1099,1035,1053,1078,1075,1105,1160,-64,18,25,-3,30,55,-5.823475887,1.739130435,2.374169041,-0.278293135,2.790697674,4.977375566
430,1004,976,1055,1076,1112,1081,1084,1094,79,21,36,-31,3,10,8.094262295,1.990521327,3.345724907,-2.787769784,0.277520814,0.922509225
431,343,843,923,953,1072,978,1020,985,80,30,119,-94,42,-35,9.489916963,3.250270856,12.48688353,-8.768656716,4.294478528,-3.431372549
432,497,1532,1650,1740,1708,1725,1721,1692,118,90,-32,17,-4,-29,7.702349869,5.454545455,-1.83908046,0.995316159,-0.231884058,-1.685066822
433,1356,1564,1531,1529,1655,1685,1676,1781,-33,-2,126,30,-9,105,-2.109974425,-0.130633573,8.240680183,1.812688822,-0.534124629,6.264916468
434,909,875,785,852,841,772,898,775,-90,67,-11,-69,126,-123,-10.28571429,8.535031847,-1.291079812,-8.20451843,16.32124352,-13.69710468
435,2205,753,722,717,747,748,719,732,-31,-5,30,1,-29,13,-4.11686587,-0.692520776,4.184100418,0.133868809,-3.877005348,1.808066759
436,154,981,1063,1054,1107,1112,1149,1233,82,-9,53,5,37,84,8.358817533,-0.846660395,5.028462998,0.451671183,3.327338129,7.310704961
437,295,866,872,958,950,959,946,949,6,86,-8,9,-13,3,0.692840647,9.862385321,-0.835073069,0.947368421,-1.355578728,0.317124736
438,707,1188,1081,1085,1115,1169,1217,1234,-107,4,30,54,48,17,-9.006734007,0.370027752,2.764976959,4.843049327,4.106073567,1.396877568
439,2204,1121,1128,1257,1213,1267,1413,1449,7,129,-44,54,146,36,0.624442462,11.43617021,-3.500397772,4.451772465,11.52328335,2.547770701
440,2414,1100,1090,1126,1201,1191,1169,1176,-10,36,75,-10,-22,7,-0.909090909,3.302752294,6.660746004,-0.832639467,-1.847187238,0.598802395
441,2019,791,993,1056,961,1142,1070,1097,202,63,-95,181,-72,27,25.53729456,6.344410876,-8.996212121,18.83454735,-6.304728546,2.523364486
442,1372,1202,993,1123,1204,1231,1300,1378,-209,130,81,27,69,78,-17.38768719,13.09164149,7.212822796,2.242524917,5.605199025,6
443,294,784,853,849,881,864,957,1017,69,-4,32,-17,93,60,8.801020408,-0.468933177,3.769140165,-1.929625426,10.76388889,6.269592476
444,1371,981,971,962,991,814,976,1027,-10,-9,29,-177,162,51,-1.019367992,-0.926879506,3.014553015,-17.86074672,19.9017199,5.225409836
445,1425,1100,1027,1020,1083,1111,1139,1177,-73,-7,63,28,28,38,-6.636363636,-0.681596884,6.176470588,2.585410896,2.520252025,3.336259877
446,2015,846,826,827,854,856,828,853,-20,1,27,2,-28,25,-2.364066194,0.121065375,3.264812576,0.234192037,-3.271028037,3.019323671
447,838,1243,1287,1273,1339,1340,1313,1341,44,-14,66,1,-27,28,3.539823009,-1.087801088,5.184603299,0.074682599,-2.014925373,2.132520944
448,2025,691,803,972,890,1015,986,851,112,169,-82,125,-29,-135,16.20839363,21.04607721,-8.436213992,14.04494382,-2.857142857,-13.69168357
449,2410,973,909,968,949,948,953,946,-64,59,-19,-1,5,-7,-6.577595067,6.490649065,-1.962809917,-0.105374078,0.52742616,-0.73452256
450,1272,1581,1502,1536,1667,1744,1817,1775,-79,34,131,77,73,-42,-4.996837445,2.263648469,8.528645833,4.619076185,4.185779817,-2.311502477
451,134,972,965,1003,1064,1051,1084,1087,-7,38,61,-13,33,3,-0.720164609,3.937823834,6.081754736,-1.221804511,3.139866794,0.276752768
452,1186,1568,1628,1682,1785,1841,1877,1789,60,54,103,56,36,-88,3.826530612,3.316953317,6.123662307,3.137254902,1.95545899,-4.688332445
453,1094,1121,1119,1162,1114,1128,1075,1055,-2,43,-48,14,-53,-20,-0.178412132,3.842716711,-4.13080895,1.256732496,-4.69858156,-1.860465116
454,783,986,898,819,832,858,887,851,-88,-79,13,26,29,-36,-8.92494929,-8.797327394,1.587301587,3.125,3.37995338,-4.058624577
455,1834,1023,953,923,979,996,1015,1037,-70,-30,56,17,19,22,-6.842619746,-3.14795383,6.067172264,1.736465781,1.907630522,2.167487685
456,1617,1142,1106,1042,1025,939,932,910,-36,-64,-17,-86,-7,-22,-3.152364273,-5.786618445,-1.631477927,-8.390243902,-0.745473908,-2.360515021
457,1782,810,860,908,896,887,873,913,50,48,-12,-9,-14,40,6.172839506,5.581395349,-1.321585903,-1.004464286,-1.578354002,4.581901489
458,1535,996,991,915,933,900,889,976,-5,-76,18,-33,-11,87,-0.502008032,-7.669021191,1.967213115,-3.536977492,-1.222222222,9.786276715
459,469,1401,1440,1528,1587,1614,1657,1734,39,88,59,27,43,77,2.78372591,6.111111111,3.861256545,1.701323251,2.664188352,4.646952323
460,369,842,696,686,802,861,835,841,-146,-10,116,59,-26,6,-17.33966746,-1.436781609,16.90962099,7.356608479,-3.019744483,0.718562874
461,524,906,896,911,947,946,980,1032,-10,15,36,-1,34,52,-1.103752759,1.674107143,3.951701427,-0.105596621,3.594080338,5.306122449
462,24,1106,1100,1167,1165,1205,1249,1285,-6,67,-2,40,44,36,-0.542495479,6.090909091,-0.171379606,3.433476395,3.651452282,2.882305845
463,1604,992,947,981,1003,1061,1089,1095,-45,34,22,58,28,6,-4.536290323,3.590285111,2.242609582,5.782652044,2.639019793,0.550964187
464,1962,1384,1346,1277,1376,1326,1394,1379,-38,-69,99,-50,68,-15,-2.74566474,-5.126300149,7.752545027,-3.63372093,5.128205128,-1.076040172
465,549,1187,1162,1163,805,1183,1236,1270,-25,1,-358,378,53,34,-2.106149958,0.08605852,-30.78245916,46.95652174,4.480135249,2.750809061
466,441,1146,1192,1116,1113,1168,1225,1274,46,-76,-3,55,57,49,4.013961606,-6.375838926,-0.268817204,4.941599281,4.880136986,4
467,186,1712,1669,1669,1706,1717,1752,1724,-43,0,37,11,35,-28,-2.511682243,0,2.216896345,0.644783118,2.038439138,-1.598173516
468,439,1255,1301,1343,1396,1382,1403,1446,46,42,53,-14,21,43,3.665338645,3.228285934,3.946388682,-1.00286533,1.519536903,3.064861012
469,860,1494,1465,1547,1548,1527,1544,1656,-29,82,1,-21,17,112,-1.941097724,5.597269625,0.064641241,-1.356589147,1.113294041,7.25388601
470,1721,988,1067,1121,1112,1097,1041,1109,79,54,-9,-15,-56,68,7.995951417,5.060918463,-0.802854594,-1.348920863,-5.104831358,6.532180596
471,620,994,1039,1044,1084,972,1028,1150,45,5,40,-112,56,122,4.527162978,0.481231954,3.831417625,-10.33210332,5.761316872,11.86770428
472,34,1309,1194,1177,1203,1207,1245,1289,-115,-17,26,4,38,44,-8.785332315,-1.423785595,2.209005947,0.332502078,3.148301574,3.534136546
473,2667,1009,966,1004,1061,1104,1189,1138,-43,38,57,43,85,-51,-4.261645193,3.933747412,5.677290837,4.052780396,7.699275362,-4.289318755
474,1168,1335,1319,1292,1379,1465,1569,1654,-16,-27,87,86,104,85,-1.198501873,-2.047005307,6.73374613,6.236403191,7.098976109,5.417463352
475,2549,750,775,736,758,751,771,803,25,-39,22,-7,20,32,3.333333333,-5.032258065,2.989130435,-0.92348285,2.663115846,4.150453956
476,552,1351,1428,1424,1462,1448,1385,1397,77,-4,38,-14,-63,12,5.699481865,-0.280112045,2.668539326,-0.957592339,-4.350828729,0.866425993
477,663,1047,1006,978,1030,1073,1140,1120,-41,-28,52,43,67,-20,-3.915950334,-2.783300199,5.316973415,4.174757282,6.24417521,-1.754385965
478,1554,894,924,977,995,954,946,953,30,53,18,-41,-8,7,3.355704698,5.735930736,1.842374616,-4.120603015,-0.838574423,0.739957717
479,888,836,913,899,1013,981,1003,1075,77,-14,114,-32,22,72,9.210526316,-1.533406353,12.6807564,-3.15893386,2.242609582,7.178464606
480,2602,958,987,881,960,972,970,945,29,-106,79,12,-2,-25,3.027139875,-10.73961499,8.96708286,1.25,-0.205761317,-2.577319588
481,788,823,897,901,929,996,1043,983,74,4,28,67,47,-60,8.991494532,0.445930881,3.107658158,7.212055974,4.718875502,-5.752636625
482,1222,1471,1390,1328,1357,1488,1549,1612,-81,-62,29,131,61,63,-5.506458192,-4.460431655,2.18373494,9.653647752,4.099462366,4.06714009
483,548,1450,1261,1364,1242,1433,1471,1796,-189,103,-122,191,38,325,-13.03448276,8.168120539,-8.944281525,15.3784219,2.651779484,22.09381373
484,526,895,816,836,961,967,1074,997,-79,20,125,6,107,-77,-8.826815642,2.450980392,14.95215311,0.624349636,11.06514995,-7.169459963
485,1904,998,961,971,940,892,924,958,-37,10,-31,-48,32,34,-3.70741483,1.040582726,-3.192584964,-5.106382979,3.587443946,3.67965368
486,791,1304,1320,1237,1272,1276,1259,1284,16,-83,35,4,-17,25,1.226993865,-6.287878788,2.829426031,0.314465409,-1.332288401,1.985702939
487,818,675,664,707,741,737,833,820,-11,43,34,-4,96,-13,-1.62962963,6.475903614,4.809052334,-0.539811066,13.02578019,-1.56062425
488,2910,1023,990,994,1016,1113,1008,934,-33,4,22,97,-105,-74,-3.225806452,0.404040404,2.213279678,9.547244094,-9.433962264,-7.341269841
489,203,863,845,853,918,923,942,1003,-18,8,65,5,19,61,-2.085747393,0.946745562,7.620164127,0.544662309,2.058504875,6.475583864
490,1042,1110,1114,1150,1164,1171,1097,1183,4,36,14,7,-74,86,0.36036036,3.231597846,1.217391304,0.60137457,-6.319385141,7.839562443
491,1679,926,1114,1163,1188,1206,1177,1099,188,49,25,18,-29,-78,20.30237581,4.398563734,2.14961307,1.515151515,-2.404643449,-6.627017842
492,394,1398,1520,1466,1512,1551,1643,1719,122,-54,46,39,92,76,8.726752504,-3.552631579,3.137789905,2.579365079,5.931656995,4.625684723
493,529,1292,1373,1352,1317,1423,1355,1371,81,-21,-35,106,-68,16,6.269349845,-1.529497451,-2.588757396,8.048595292,-4.778636683,1.180811808
494,528,1201,1224,1210,1241,1258,1334,1428,23,-14,31,17,76,94,1.915070774,-1.14379085,2.561983471,1.369863014,6.041335453,7.046476762
495,1531,826,832,816,832,843,806,816,6,-16,16,11,-37,10,0.726392252,-1.923076923,1.960784314,1.322115385,-4.389086595,1.240694789
496,565,1147,1060,1057,1039,1093,1139,1189,-87,-3,-18,54,46,50,-7.585004359,-0.283018868,-1.702932829,5.197305101,4.208600183,4.389815628
497,2087,1040,1084,1109,1184,1163,1158,1197,44,25,75,-21,-5,39,4.230769231,2.306273063,6.762849414,-1.773648649,-0.429922614,3.367875648
498,1734,902,889,923,909,958,961,991,-13,34,-14,49,3,30,-1.441241685,3.824521935,-1.516793066,5.390539054,0.313152401,3.121748179
499,2820,866,942,957,973,1060,1086,1160,76,15,16,87,26,74,8.775981524,1.592356688,1.671891327,8.941418294,2.452830189,6.813996317
500,1751,1130,1059,1005,1071,1128,1198,1286,-71,-54,66,57,70,88,-6.283185841,-5.099150142,6.567164179,5.322128852,6.205673759,7.34557596
501,1133,1375,1396,1370,1375,1440,1635,1750,21,-26,5,65,195,115,1.527272727,-1.862464183,0.364963504,4.727272727,13.54166667,7.033639144
502,2318,1130,1048,1060,1157,1148,1163,1228,-82,12,97,-9,15,65,-7.256637168,1.145038168,9.150943396,-0.777873812,1.306620209,5.588993981
503,1790,1056,852,778,798,899,941,890,-204,-74,20,101,42,-51,-19.31818182,-8.685446009,2.570694087,12.6566416,4.67185762,-5.419766206
504,814,1280,1293,1295,1233,1209,1253,1255,13,2,-62,-24,44,2,1.015625,0.154679041,-4.787644788,-1.946472019,3.639371381,0.159616919
505,156,1655,1579,1559,1616,1660,1753,1740,-76,-20,57,44,93,-13,-4.592145015,-1.266624446,3.656189865,2.722772277,5.602409639,-0.741585853
506,728,1328,1355,1344,1377,1380,1390,1329,27,-11,33,3,10,-61,2.03313253,-0.811808118,2.455357143,0.217864924,0.724637681,-4.388489209
507,1407,1196,1082,1034,1167,1156,1275,1270,-114,-48,133,-11,119,-5,-9.531772575,-4.436229205,12.86266925,-0.942587832,10.29411765,-0.392156863
508,2841,1086,1076,1065,1181,1185,1238,1225,-10,-11,116,4,53,-13,-0.920810313,-1.022304833,10.89201878,0.33869602,4.47257384,-1.050080775
509,896,1405,1590,1620,1642,1597,1677,1676,185,30,22,-45,80,-1,13.16725979,1.886792453,1.358024691,-2.740560292,5.009392611,-0.059630292
510,1502,984,927,930,931,964,991,1035,-57,3,1,33,27,44,-5.792682927,0.323624595,0.107526882,3.544575725,2.800829876,4.439959637
511,2049,1053,978,976,980,957,968,1002,-75,-2,4,-23,11,34,-7.122507123,-0.204498978,0.409836066,-2.346938776,1.149425287,3.512396694
512,572,1000,828,856,924,899,1041,1010,-172,28,68,-25,142,-31,-17.2,3.381642512,7.943925234,-2.705627706,15.79532814,-2.97790586
513,1385,1200,1206,1420,1299,1362,1297,1433,6,214,-121,63,-65,136,0.5,17.74461028,-8.521126761,4.849884527,-4.772393539,10.48573631
514,720,999,995,990,997,994,1036,1041,-4,-5,7,-3,42,5,-0.4004004,-0.502512563,0.707070707,-0.300902708,4.225352113,0.482625483
515,1388,1200,975,1148,1115,1228,1205,1368,-225,173,-33,113,-23,163,-18.75,17.74358974,-2.87456446,10.13452915,-1.872964169,13.52697095
516,1002,1510,1347,1464,1420,1508,1601,1587,-163,117,-44,88,93,-14,-10.79470199,8.68596882,-3.005464481,6.197183099,6.167108753,-0.874453467
517,1440,814,727,739,751,757,747,757,-87,12,12,6,-10,10,-10.68796069,1.650618982,1.623815968,0.798934754,-1.321003963,1.338688086
518,1808,1015,994,924,1057,1033,1028,1050,-21,-70,133,-24,-5,22,-2.068965517,-7.042253521,14.39393939,-2.270577105,-0.484027106,2.140077821
519,2490,1023,1118,1004,1180,1201,1195,1093,95,-114,176,21,-6,-102,9.286412512,-10.19677996,17.52988048,1.779661017,-0.49958368,-8.535564854
520,406,854,955,897,955,940,877,908,101,-58,58,-15,-63,31,11.82669789,-6.073298429,6.46599777,-1.570680628,-6.70212766,3.534777651
521,584,794,981,1062,1006,1099,1066,1045,187,81,-56,93,-33,-21,23.55163728,8.256880734,-5.27306968,9.244532803,-3.002729754,-1.969981238
522,530,963,991,1004,1043,1055,1088,1124,28,13,39,12,33,36,2.907580478,1.311806256,3.884462151,1.150527325,3.127962085,3.308823529
523,1589,994,838,780,800,802,831,838,-156,-58,20,2,29,7,-15.69416499,-6.92124105,2.564102564,0.25,3.6159601,0.842358604
524,2017,712,777,785,756,745,754,834,65,8,-29,-11,9,80,9.129213483,1.02960103,-3.694267516,-1.455026455,1.208053691,10.61007958
525,2062,955,1008,1011,1041,1041,1085,1000,53,3,30,0,44,-85,5.54973822,0.297619048,2.96735905,0,4.226705091,-7.834101382
526,465,1023,880,826,837,854,854,955,-143,-54,11,17,0,101,-13.97849462,-6.136363636,1.331719128,2.031063321,0,11.82669789
527,1331,1118,994,1062,1025,1133,1061,1090,-124,68,-37,108,-72,29,-11.09123435,6.841046278,-3.483992467,10.53658537,-6.354810238,2.7332705
528,933,748,918,930,905,1047,1004,1058,170,12,-25,142,-43,54,22.72727273,1.307189542,-2.688172043,15.69060773,-4.106972302,5.378486056
529,2340,827,810,806,816,815,795,844,-17,-4,10,-1,-20,49,-2.055622733,-0.49382716,1.240694789,-0.12254902,-2.45398773,6.163522013
530,671,770,782,816,854,820,840,899,12,34,38,-34,20,59,1.558441558,4.347826087,4.656862745,-3.981264637,2.43902439,7.023809524
531,1919,1447,1463,1343,1351,1408,1471,1573,16,-120,8,57,63,102,1.105736006,-8.202323992,0.59568131,4.219096965,4.474431818,6.934058464
532,2522,1145,1080,1032,964,984,948,938,-65,-48,-68,20,-36,-10,-5.676855895,-4.444444444,-6.589147287,2.074688797,-3.658536585,-1.054852321
533,1986,804,774,754,801,809,779,793,-30,-20,47,8,-30,14,-3.731343284,-2.583979328,6.233421751,0.998751561,-3.708281829,1.797175866
534,1227,778,761,785,794,796,816,837,-17,24,9,2,20,21,-2.185089974,3.153745072,1.146496815,0.251889169,2.512562814,2.573529412
535,2234,867,859,867,885,865,887,866,-8,8,18,-20,22,-21,-0.92272203,0.931315483,2.076124567,-2.259887006,2.543352601,-2.367531003
536,254,1200,1156,1148,1270,1293,1249,1291,-44,-8,122,23,-44,42,-3.666666667,-0.692041522,10.6271777,1.811023622,-3.402938902,3.362690152
537,1447,833,869,846,858,728,736,794,36,-23,12,-130,8,58,4.321728691,-2.646720368,1.418439716,-15.15151515,1.098901099,7.880434783
538,1883,1195,1123,1267,1283,1289,1339,1337,-72,144,16,6,50,-2,-6.025104603,12.82279608,1.262825572,0.467653936,3.87897595,-0.149365198
539,104,1070,1092,1091,1261,1290,1349,1372,22,-1,170,29,59,23,2.056074766,-0.091575092,15.58203483,2.299762094,4.573643411,1.704966642
540,474,838,885,853,909,922,991,965,47,-32,56,13,69,-26,5.608591885,-3.615819209,6.565064478,1.430143014,7.48373102,-2.623612513
541,1123,682,650,702,700,721,736,710,-32,52,-2,21,15,-26,-4.692082111,8,-0.284900285,3,2.080443828,-3.532608696
542,1328,1209,1216,1021,1053,1238,1197,1166,7,-195,32,185,-41,-31,0.578990902,-16.03618421,3.134182174,17.5688509,-3.311793215,-2.589807853
543,1770,1157,1142,1160,1233,1218,1257,1252,-15,18,73,-15,39,-5,-1.296456353,1.576182137,6.293103448,-1.216545012,3.201970443,-0.397772474
544,1527,1518,1392,1340,1283,1210,1297,1350,-126,-52,-57,-73,87,53,-8.300395257,-3.735632184,-4.253731343,-5.689789556,7.190082645,4.086353123
545,1320,1279,1290,1352,1389,1449,1456,1493,11,62,37,60,7,37,0.860046912,4.80620155,2.736686391,4.319654428,0.483091787,2.541208791
546,1193,911,974,905,969,980,999,1022,63,-69,64,11,19,23,6.915477497,-7.084188912,7.071823204,1.135190918,1.93877551,2.302302302
547,1922,1148,1150,1150,1218,1219,1263,1288,2,0,68,1,44,25,0.174216028,0,5.913043478,0.082101806,3.609515997,1.979414093
548,993,1234,1213,1131,1214,1321,1509,1591,-21,-82,83,107,188,82,-1.70178282,-6.760098928,7.338638373,8.81383855,14.23164269,5.434062293
549,1174,1250,1218,1207,1248,1309,1352,1430,-32,-11,41,61,43,78,-2.56,-0.903119869,3.396851698,4.887820513,3.284950344,5.769230769
550,1584,994,957,935,959,1021,1015,1089,-37,-22,24,62,-6,74,-3.722334004,-2.298850575,2.56684492,6.465067779,-0.587659158,7.290640394
551,2021,909,938,958,963,928,1018,889,29,20,5,-35,90,-129,3.190319032,2.132196162,0.521920668,-3.634475597,9.698275862,-12.6719057
552,560,829,840,840,829,826,834,804,11,0,-11,-3,8,-30,1.326899879,0,-1.30952381,-0.361881785,0.968523002,-3.597122302
553,735,1019,1006,1138,1061,999,1031,980,-13,132,-77,-62,32,-51,-1.27576055,13.12127237,-6.766256591,-5.843543827,3.203203203,-4.946653734
554,1269,1064,1090,1067,1125,1174,1246,1254,26,-23,58,49,72,8,2.443609023,-2.110091743,5.435801312,4.355555556,6.132879046,0.642054575
555,538,955,993,998,1009,1146,1191,1240,38,5,11,137,45,49,3.979057592,0.503524673,1.102204409,13.5777998,3.926701571,4.114189757
556,510,865,890,882,904,893,887,920,25,-8,22,-11,-6,33,2.89017341,-0.898876404,2.494331066,-1.216814159,-0.671892497,3.720405862
557,2651,1181,1197,1194,1216,1150,1128,1085,16,-3,22,-66,-22,-43,1.354784081,-0.250626566,1.842546064,-5.427631579,-1.913043478,-3.812056738
558,1228,1500,1575,1571,1673,1700,1702,1685,75,-4,102,27,2,-17,5,-0.253968254,6.492679822,1.613867304,0.117647059,-0.998824912
559,3022,655,694,875,865,902,983,753,39,181,-10,37,81,-230,5.954198473,26.08069164,-1.142857143,4.277456647,8.980044346,-23.39776195
560,1086,887,933,960,988,1036,1106,1044,46,27,28,48,70,-62,5.186020293,2.893890675,2.916666667,4.858299595,6.756756757,-5.605786618
561,49,749,1079,992,1023,1083,1189,1192,330,-87,31,60,106,3,44.05874499,-8.063021316,3.125,5.865102639,9.787626962,0.252312868
562,1209,1124,1018,1251,1205,1280,1301,1243,-106,233,-46,75,21,-58,-9.430604982,22.88801572,-3.677058353,6.22406639,1.640625,-4.458109147
563,103,1397,1363,1405,1240,1394,1444,1494,-34,42,-165,154,50,50,-2.433786686,3.081438004,-11.74377224,12.41935484,3.586800574,3.462603878
564,265,1500,1528,1605,1618,1506,1697,1798,28,77,13,-112,191,101,1.866666667,5.039267016,0.809968847,-6.922126082,12.68260292,5.951679434
565,293,1143,1176,1167,1189,1227,1199,1200,33,-9,22,38,-28,1,2.887139108,-0.765306122,1.885175664,3.195962994,-2.28198859,0.083402836
566,2238,949,1032,997,1046,1055,1142,1169,83,-35,49,9,87,27,8.746048472,-3.391472868,4.914744233,0.86042065,8.246445498,2.364273205
567,2645,970,832,917,913,871,893,868,-138,85,-4,-42,22,-25,-14.22680412,10.21634615,-0.436205016,-4.600219058,2.525832377,-2.799552072
568,1441,1209,1124,1276,1189,1271,1229,1302,-85,152,-87,82,-42,73,-7.030603805,13.52313167,-6.818181818,6.896551724,-3.304484658,5.939788446
569,1577,1000,1115,984,975,1010,1072,1078,115,-131,-9,35,62,6,11.5,-11.74887892,-0.914634146,3.58974359,6.138613861,0.559701493
570,1988,863,897,851,853,855,745,736,34,-46,2,2,-110,-9,3.939745075,-5.128205128,0.235017626,0.234466589,-12.86549708,-1.208053691
571,372,1254,1306,1420,1412,1543,1451,1486,52,114,-8,131,-92,35,4.146730463,8.728943338,-0.563380282,9.277620397,-5.962410888,2.412129566
572,1740,940,929,923,933,934,929,959,-11,-6,10,1,-5,30,-1.170212766,-0.645855759,1.083423619,0.107181136,-0.535331906,3.229278794
573,356,997,1062,1006,1045,995,1035,1019,65,-56,39,-50,40,-16,6.519558676,-5.27306968,3.876739563,-4.784688995,4.020100503,-1.54589372
574,780,842,863,878,909,930,988,968,21,15,31,21,58,-20,2.494061758,1.738122827,3.530751708,2.310231023,6.23655914,-2.024291498
575,1504,1200,1167,1136,1207,1288,1309,1307,-33,-31,71,81,21,-2,-2.75,-2.65638389,6.25,6.710853355,1.630434783,-0.152788388
576,178,1599,1613,1656,1701,1679,1693,1637,14,43,45,-22,14,-56,0.875547217,2.66584005,2.717391304,-1.293356849,0.833829661,-3.307737744
577,1149,689,663,703,718,738,747,693,-26,40,15,20,9,-54,-3.773584906,6.033182504,2.13371266,2.78551532,1.219512195,-7.228915663
578,338,1008,1119,1112,1176,1113,1130,1104,111,-7,64,-63,17,-26,11.01190476,-0.625558534,5.755395683,-5.357142857,1.527403414,-2.300884956
579,2919,651,657,765,774,802,749,681,6,108,9,28,-53,-68,0.921658986,16.43835616,1.176470588,3.617571059,-6.608478803,-9.078771696
580,1714,1251,1210,1184,1208,1278,1265,1303,-41,-26,24,70,-13,38,-3.277378098,-2.148760331,2.027027027,5.794701987,-1.017214397,3.003952569
581,1157,1285,1242,1280,1356,1416,1491,1489,-43,38,76,60,75,-2,-3.346303502,3.05958132,5.9375,4.424778761,5.296610169,-0.134138162
582,1264,970,926,948,988,990,1021,987,-44,22,40,2,31,-34,-4.536082474,2.375809935,4.219409283,0.20242915,3.131313131,-3.33006856
583,982,743,753,795,884,857,897,857,10,42,89,-27,40,-40,1.34589502,5.577689243,11.19496855,-3.054298643,4.667444574,-4.459308807
584,1459,1138,1154,1147,1193,1200,1190,1045,16,-7,46,7,-10,-145,1.405975395,-0.606585789,4.010462075,0.586756077,-0.833333333,-12.18487395
585,476,974,972,1002,1007,941,1018,892,-2,30,5,-66,77,-126,-0.205338809,3.086419753,0.499001996,-6.554121152,8.182784272,-12.37721022
586,605,1153,1187,915,974,1078,1116,1101,34,-272,59,104,38,-15,2.948829141,-22.91491154,6.448087432,10.67761807,3.525046382,-1.344086022
587,1797,1100,1025,971,1067,1040,1095,1104,-75,-54,96,-27,55,9,-6.818181818,-5.268292683,9.886714727,-2.530459231,5.288461538,0.821917808
588,41,1538,1562,1538,1568,1611,1628,1663,24,-24,30,43,17,35,1.56046814,-1.536491677,1.950585176,2.742346939,1.055245189,2.14987715
589,1678,908,999,1062,1031,986,947,937,91,63,-31,-45,-39,-10,10.02202643,6.306306306,-2.919020716,-4.364694471,-3.955375254,-1.055966209
590,2554,1015,988,989,1009,1016,1041,959,-27,1,20,7,25,-82,-2.660098522,0.101214575,2.022244692,0.693756194,2.460629921,-7.877041306
591,224,1008,1310,1279,1300,1443,1450,1544,302,-31,21,143,7,94,29.96031746,-2.366412214,1.64190774,11,0.485100485,6.482758621
592,1285,1277,1278,1330,1345,1497,1564,1586,1,52,15,152,67,22,0.078308536,4.06885759,1.127819549,11.30111524,4.475617902,1.406649616
593,535,892,889,853,911,890,953,1074,-3,-36,58,-21,63,121,-0.33632287,-4.049493813,6.799531067,-2.305159166,7.078651685,12.69674711
594,2252,816,828,814,838,847,820,817,12,-14,24,9,-27,-3,1.470588235,-1.690821256,2.948402948,1.07398568,-3.18772137,-0.365853659
595,2331,954,940,912,932,926,851,861,-14,-28,20,-6,-75,10,-1.467505241,-2.978723404,2.192982456,-0.643776824,-8.099352052,1.175088132
596,1555,868,896,872,875,897,897,940,28,-24,3,22,0,43,3.225806452,-2.678571429,0.344036697,2.514285714,0,4.793756968
597,354,994,1099,1142,1160,1180,1287,1309,105,43,18,20,107,22,10.56338028,3.912647862,1.576182137,1.724137931,9.06779661,1.709401709
598,1409,1202,1235,1226,1123,1199,1287,1355,33,-9,-103,76,88,68,2.745424293,-0.728744939,-8.401305057,6.767586821,7.339449541,5.283605284
599,1298,1255,1217,1271,1267,1305,1335,1319,-38,54,-4,38,30,-16,-3.027888446,4.437140509,-0.314712825,2.999210734,2.298850575,-1.198501873
600,1622,1027,947,960,1059,1074,1142,1214,-80,13,99,15,68,72,-7.789678676,1.372756072,10.3125,1.416430595,6.331471136,6.304728546
601,25,1424,1436,1463,1526,1525,1579,1644,12,27,63,-1,54,65,0.842696629,1.880222841,4.306220096,-0.065530799,3.540983607,4.116529449
602,148,1217,1288,1295,1375,1395,1363,1390,71,7,80,20,-32,27,5.834018077,0.543478261,6.177606178,1.454545455,-2.29390681,1.980924431
603,1252,1154,1116,1076,1120,1144,1185,1226,-38,-40,44,24,41,41,-3.292894281,-3.584229391,4.089219331,2.142857143,3.583916084,3.459915612
604,1981,1225,1208,1207,1153,1119,1141,1150,-17,-1,-54,-34,22,9,-1.387755102,-0.082781457,-4.473902237,-2.948829141,1.966041108,0.78878177
605,1534,819,752,737,786,775,755,789,-67,-15,49,-11,-20,34,-8.180708181,-1.994680851,6.648575305,-1.399491094,-2.580645161,4.503311258
606,812,968,912,916,914,1005,1040,1018,-56,4,-2,91,35,-22,-5.785123967,0.438596491,-0.218340611,9.956236324,3.482587065,-2.115384615
607,500,1334,1375,1406,1369,1398,1313,1300,41,31,-37,29,-85,-13,3.073463268,2.254545455,-2.631578947,2.118334551,-6.080114449,-0.99009901
608,1274,968,963,995,1030,1072,1141,1167,-5,32,35,42,69,26,-0.516528926,3.322949117,3.51758794,4.077669903,6.436567164,2.278702892
609,2627,799,815,781,783,789,800,870,16,-34,2,6,11,70,2.002503129,-4.171779141,0.256081946,0.766283525,1.394169835,8.75
610,850,899,892,898,912,943,955,1004,-7,6,14,31,12,49,-0.778642937,0.67264574,1.559020045,3.399122807,1.272534464,5.130890052
611,1176,990,888,979,1006,1008,1009,1068,-102,91,27,2,1,59,-10.3030303,10.24774775,2.757916241,0.198807157,0.099206349,5.847373637
612,1366,797,830,799,848,897,875,946,33,-31,49,49,-22,71,4.140526976,-3.734939759,6.132665832,5.778301887,-2.452619844,8.114285714
613,1670,1036,1031,1018,1022,1039,1043,1108,-5,-13,4,17,4,65,-0.482625483,-1.260911736,0.392927308,1.663405088,0.384985563,6.232023011
614,1163,1200,1202,1220,1279,1300,1343,1392,2,18,59,21,43,49,0.166666667,1.49750416,4.836065574,1.64190774,3.307692308,3.648548027
615,1242,841,845,832,856,858,854,884,4,-13,24,2,-4,30,0.475624257,-1.538461538,2.884615385,0.23364486,-0.466200466,3.512880562
616,618,983,1102,1079,1073,1034,1043,1030,119,-23,-6,-39,9,-13,12.10579858,-2.087114338,-0.556070436,-3.634669152,0.87040619,-1.246404602
617,667,1099,1134,1151,1223,1239,1266,1215,35,17,72,16,27,-51,3.184713376,1.499118166,6.255430061,1.308258381,2.179176755,-4.028436019
618,2589,860,895,867,938,978,986,984,35,-28,71,40,8,-2,4.069767442,-3.12849162,8.189158016,4.264392324,0.81799591,-0.202839757
619,31,2178,2122,2179,2303,2350,2449,2483,-56,57,124,47,99,34,-2.571166208,2.686145146,5.6906838,2.040816327,4.212765957,1.388321764
620,887,1295,1350,1351,1366,1463,1592,1752,55,1,15,97,129,160,4.247104247,0.074074074,1.110288675,7.10102489,8.817498291,10.05025126
621,1524,1288,1330,1333,1393,1439,1448,1526,42,3,60,46,9,78,3.260869565,0.22556391,4.501125281,3.302225413,0.625434329,5.386740331
622,883,958,978,950,901,903,847,905,20,-28,-49,2,-56,58,2.087682672,-2.862985685,-5.157894737,0.221975583,-6.201550388,6.847697757
623,1668,1267,1258,1235,1280,1332,1344,1313,-9,-23,45,52,12,-31,-0.710339384,-1.828298887,3.643724696,4.0625,0.900900901,-2.306547619
624,166,987,967,987,996,1106,1166,1201,-20,20,9,110,60,35,-2.026342452,2.068252327,0.911854103,11.04417671,5.424954792,3.001715266
625,769,775,806,864,863,838,830,850,31,58,-1,-25,-8,20,4,7.196029777,-0.115740741,-2.896871379,-0.954653938,2.409638554
626,1647,1023,840,872,851,820,886,876,-183,32,-21,-31,66,-10,-17.88856305,3.80952381,-2.408256881,-3.642773208,8.048780488,-1.128668172
627,1304,991,962,961,959,986,949,969,-29,-1,-2,27,-37,20,-2.926337033,-0.103950104,-0.208116545,2.815432742,-3.752535497,2.10748156
628,2251,1056,1099,1146,1154,1206,1223,1292,43,47,8,52,17,69,4.071969697,4.276615105,0.698080279,4.506065858,1.409618574,5.641864268
629,1023,747,770,792,758,780,792,785,23,22,-34,22,12,-7,3.078982597,2.857142857,-4.292929293,2.90237467,1.538461538,-0.883838384
630,1398,873,776,773,689,749,798,819,-97,-3,-84,60,49,21,-11.11111111,-0.386597938,-10.86675291,8.708272859,6.542056075,2.631578947
631,157,2277,2282,2295,2327,2310,2426,2455,5,13,32,-17,116,29,0.219587176,0.569675723,1.394335512,-0.730554362,5.021645022,1.195383347
632,1672,985,978,1001,1003,1083,1148,1052,-7,23,2,80,65,-96,-0.710659898,2.351738241,0.1998002,7.976071785,6.001846722,-8.362369338
633,67,1878,1817,1962,2073,2273,2297,2195,-61,145,111,200,24,-102,-3.248136315,7.980187122,5.657492355,9.647853353,1.055873295,-4.440574663
634,2144,967,966,1012,1050,1071,1145,1114,-1,46,38,21,74,-31,-0.103412616,4.761904762,3.754940711,2,6.909430439,-2.707423581
635,1015,672,652,697,723,735,758,749,-20,45,26,12,23,-9,-2.976190476,6.901840491,3.730272597,1.659751037,3.129251701,-1.187335092
636,2536,944,804,900,822,862,939,852,-140,96,-78,40,77,-87,-14.83050847,11.94029851,-8.666666667,4.866180049,8.932714617,-9.265175719
637,972,1173,1138,1207,1218,1203,1184,1220,-35,69,11,-15,-19,36,-2.983802217,6.063268893,0.911350456,-1.231527094,-1.579384871,3.040540541
638,1881,889,889,898,920,936,959,939,0,9,22,16,23,-20,0,1.012373453,2.449888641,1.739130435,2.457264957,-2.085505735
639,418,1066,849,798,861,952,948,1075,-217,-51,63,91,-4,127,-20.3564728,-6.007067138,7.894736842,10.56910569,-0.420168067,13.39662447
640,311,2137,2138,2206,2288,2280,2302,2340,1,68,82,-8,22,38,0.046794572,3.180542563,3.717135086,-0.34965035,0.964912281,1.650738488
641,1641,890,772,782,840,821,854,880,-118,10,58,-19,33,26,-13.25842697,1.295336788,7.416879795,-2.261904762,4.019488429,3.044496487
642,1430,1015,1133,1122,1095,1207,1201,1008,118,-11,-27,112,-6,-193,11.62561576,-0.970873786,-2.406417112,10.2283105,-0.497100249,-16.06994172
643,236,1735,1385,1128,1060,1165,1105,1116,-350,-257,-68,105,-60,11,-20.17291066,-18.55595668,-6.028368794,9.905660377,-5.150214592,0.995475113
644,732,784,778,820,864,836,847,860,-6,42,44,-28,11,13,-0.765306122,5.398457584,5.365853659,-3.240740741,1.315789474,1.534828808
645,1309,1139,1114,1121,1216,1288,1325,1447,-25,7,95,72,37,122,-2.194907814,0.628366248,8.474576271,5.921052632,2.872670807,9.20754717
646,938,1794,1669,1604,1543,1545,1593,1642,-125,-65,-61,2,48,49,-6.967670011,-3.894547633,-3.802992519,0.129617628,3.106796117,3.075957313
647,1467,1062,882,704,892,943,1034,1039,-180,-178,188,51,91,5,-16.94915254,-20.1814059,26.70454545,5.717488789,9.650053022,0.483558994
648,1786,1151,968,883,909,828,865,860,-183,-85,26,-81,37,-5,-15.89921807,-8.780991736,2.944507361,-8.910891089,4.468599034,-0.578034682
649,261,899,927,979,1025,1044,1097,1120,28,52,46,19,53,23,3.114571746,5.609492988,4.698672114,1.853658537,5.076628352,2.096627165
650,2332,1034,837,892,870,802,836,802,-197,55,-22,-68,34,-34,-19.05222437,6.571087216,-2.466367713,-7.816091954,4.239401496,-4.066985646
651,1731,1486,1441,1394,1442,1374,1322,1289,-45,-47,48,-68,-52,-33,-3.028263795,-3.261623872,3.443328551,-4.715672677,-3.784570597,-2.496217852
652,1438,1126,836,907,1024,991,926,970,-290,71,117,-33,-65,44,-25.75488455,8.492822967,12.89966924,-3.22265625,-6.559031282,4.75161987
653,713,1200,1222,1240,1322,1237,1307,1342,22,18,82,-85,70,35,1.833333333,1.47299509,6.612903226,-6.429652042,5.658852061,2.677888294
654,437,1304,1172,1223,1287,1307,1436,1576,-132,51,64,20,129,140,-10.12269939,4.351535836,5.233033524,1.554001554,9.86993114,9.749303621
655,1667,1422,1439,1419,1558,1514,1436,1474,17,-20,139,-44,-78,38,1.195499297,-1.389854065,9.795630726,-2.824133504,-5.151915456,2.646239554
656,638,1145,1135,1196,1191,1211,1200,1238,-10,61,-5,20,-11,38,-0.873362445,5.374449339,-0.418060201,1.679261125,-0.908340215,3.166666667
657,2214,1054,910,1023,1093,1143,1013,984,-144,113,70,50,-130,-29,-13.66223909,12.41758242,6.842619746,4.574565416,-11.3735783,-2.86278381
658,1943,738,772,797,815,789,792,782,34,25,18,-26,3,-10,4.60704607,3.238341969,2.25846926,-3.190184049,0.380228137,-1.262626263
659,1530,866,902,967,971,759,680,873,36,65,4,-212,-79,193,4.15704388,7.206208426,0.413650465,-21.83316169,-10.40843215,28.38235294
660,1478,1163,1163,1108,1105,1208,1294,1312,0,-55,-3,103,86,18,0,-4.729148753,-0.270758123,9.321266968,7.119205298,1.391035549
661,1590,923,882,806,910,977,971,976,-41,-76,104,67,-6,5,-4.442036836,-8.616780045,12.90322581,7.362637363,-0.614124872,0.514933059
662,2314,799,875,907,875,948,935,899,76,32,-32,73,-13,-36,9.511889862,3.657142857,-3.528114664,8.342857143,-1.371308017,-3.85026738
663,2699,1122,1183,1006,1168,1215,1204,1049,61,-177,162,47,-11,-155,5.436720143,-14.96196112,16.10337972,4.023972603,-0.905349794,-12.87375415
664,1282,1119,900,812,808,896,955,857,-219,-88,-4,88,59,-98,-19.57104558,-9.777777778,-0.492610837,10.89108911,6.584821429,-10.2617801
665,1181,760,901,884,897,944,982,1030,141,-17,13,47,38,48,18.55263158,-1.886792453,1.470588235,5.239687848,4.025423729,4.887983707
666,1305,998,1090,1013,1039,1053,1036,1002,92,-77,26,14,-17,-34,9.218436874,-7.064220183,2.566633761,1.347449471,-1.614434948,-3.281853282
667,691,1091,1170,1083,1150,1158,1209,1240,79,-87,67,8,51,31,7.241063245,-7.435897436,6.186518929,0.695652174,4.404145078,2.564102564
668,761,787,845,841,830,866,888,897,58,-4,-11,36,22,9,7.369758577,-0.473372781,-1.307966706,4.337349398,2.540415704,1.013513514
669,829,693,687,714,751,750,772,743,-6,27,37,-1,22,-29,-0.865800866,3.930131004,5.182072829,-0.133155792,2.933333333,-3.756476684
670,205,1086,1089,1125,1154,1229,1331,1444,3,36,29,75,102,113,0.276243094,3.305785124,2.577777778,6.499133449,8.299430431,8.48985725
671,485,1786,1768,1781,1804,1809,1834,1827,-18,13,23,5,25,-7,-1.007838746,0.735294118,1.291409321,0.277161863,1.381978994,-0.381679389
672,1942,935,916,908,905,925,906,950,-19,-8,-3,20,-19,44,-2.032085561,-0.873362445,-0.330396476,2.209944751,-2.054054054,4.856512141
673,849,1022,1089,1032,1115,1112,1232,1222,67,-57,83,-3,120,-10,6.555772994,-5.23415978,8.042635659,-0.269058296,10.79136691,-0.811688312
674,1718,1001,1103,1045,1157,1189,1185,1127,102,-58,112,32,-4,-58,10.18981019,-5.258386219,10.71770335,2.765773552,-0.336417157,-4.894514768
675,66,900,883,818,852,913,972,949,-17,-65,34,61,59,-23,-1.888888889,-7.361268403,4.156479218,7.159624413,6.462212486,-2.366255144
676,445,751,769,796,779,739,757,749,18,27,-17,-40,18,-8,2.396804261,3.511053316,-2.135678392,-5.13478819,2.435723951,-1.05680317
677,86,1381,1467,1497,1641,1791,1976,2042,86,30,144,150,185,66,6.22737147,2.044989775,9.619238477,9.140767824,10.3294249,3.340080972
678,2102,1150,1163,1164,1207,1092,1099,1105,13,1,43,-115,7,6,1.130434783,0.085984523,3.694158076,-9.527754764,0.641025641,0.545950864
679,2569,916,888,909,896,897,893,939,-28,21,-13,1,-4,46,-3.056768559,2.364864865,-1.430143014,0.111607143,-0.445930881,5.151175812
680,966,969,866,888,916,1006,1042,1064,-103,22,28,90,36,22,-10.62951496,2.540415704,3.153153153,9.825327511,3.578528827,2.111324376
681,1708,909,839,811,908,906,890,898,-70,-28,97,-2,-16,8,-7.700770077,-3.337306317,11.96054254,-0.220264317,-1.766004415,0.898876404
682,1874,906,918,947,999,970,971,1012,12,29,52,-29,1,41,1.324503311,3.159041394,5.491024287,-2.902902903,0.103092784,4.222451081
683,57,950,1012,977,1005,1043,1122,1168,62,-35,28,38,79,46,6.526315789,-3.458498024,2.86591607,3.781094527,7.57430489,4.099821747
684,194,999,1106,1063,1109,1141,1145,1126,107,-43,46,32,4,-19,10.71071071,-3.887884268,4.327375353,2.885482417,0.350569676,-1.659388646
685,2894,783,752,780,790,791,727,793,-31,28,10,1,-64,66,-3.959131545,3.723404255,1.282051282,0.126582278,-8.09102402,9.078404402
686,334,1409,1443,1389,1241,1316,1230,1268,34,-54,-148,75,-86,38,2.413058907,-3.742203742,-10.65514759,6.043513296,-6.534954407,3.089430894
687,1442,769,790,803,837,824,712,752,21,13,34,-13,-112,40,2.730819246,1.64556962,4.234122042,-1.553166069,-13.59223301,5.617977528
688,895,875,891,926,993,1043,1193,1281,16,35,67,50,150,88,1.828571429,3.928170595,7.235421166,5.035246727,14.38159156,7.376362112
689,582,952,981,982,1020,995,1032,1028,29,1,38,-25,37,-4,3.046218487,0.101936799,3.869653768,-2.450980392,3.718592965,-0.387596899
690,1238,1118,1064,877,908,1017,1011,1082,-54,-187,31,109,-6,71,-4.830053667,-17.57518797,3.534777651,12.00440529,-0.589970501,7.022749753
691,793,1292,1274,1315,1337,1260,1491,1608,-18,41,22,-77,231,117,-1.393188854,3.218210361,1.673003802,-5.759162304,18.33333333,7.847082495
692,566,1264,1270,1253,1342,1361,1394,1346,6,-17,89,19,33,-48,0.474683544,-1.338582677,7.102952913,1.415797317,2.42468773,-3.443328551
693,607,927,954,914,894,899,1011,956,27,-40,-20,5,112,-55,2.912621359,-4.192872117,-2.188183807,0.559284116,12.45828699,-5.440158259
694,1826,1457,1383,1420,1424,1366,1300,1257,-74,37,4,-58,-66,-43,-5.078929307,2.675343456,0.281690141,-4.073033708,-4.831625183,-3.307692308
695,1791,748,755,784,847,809,815,800,7,29,63,-38,6,-15,0.935828877,3.841059603,8.035714286,-4.486422668,0.741656366,-1.840490798
696,308,1258,1325,1329,1293,1414,1434,1471,67,4,-36,121,20,37,5.325914149,0.301886792,-2.708803612,9.35808198,1.414427157,2.580195258
697,1306,1155,1088,1154,1175,1196,1206,1221,-67,66,21,21,10,15,-5.800865801,6.066176471,1.819757366,1.787234043,0.836120401,1.243781095
698,1187,1291,1556,1620,1636,1702,1736,1806,265,64,16,66,34,70,20.52672347,4.11311054,0.987654321,4.034229829,1.997649824,4.032258065
699,2057,817,827,834,825,819,815,857,10,7,-9,-6,-4,42,1.223990208,0.84643289,-1.079136691,-0.727272727,-0.488400488,5.153374233
700,1516,974,961,930,921,1130,1039,1140,-13,-31,-9,209,-91,101,-1.334702259,-3.225806452,-0.967741935,22.6927253,-8.053097345,9.720885467
701,276,1184,1185,1202,1186,1274,1315,1405,1,17,-16,88,41,90,0.084459459,1.434599156,-1.331114809,7.41989882,3.218210361,6.844106464
702,241,998,1027,1009,1129,1113,1150,1215,29,-18,120,-16,37,65,2.905811623,-1.752677702,11.89296333,-1.417183348,3.324348607,5.652173913
703,1059,650,665,725,767,753,796,749,15,60,42,-14,43,-47,2.307692308,9.022556391,5.793103448,-1.825293351,5.710491368,-5.904522613
704,1074,877,877,855,892,857,851,870,0,-22,37,-35,-6,19,0,-2.508551881,4.32748538,-3.923766816,-0.700116686,2.23266745
705,2497,1009,991,1024,1088,1039,1075,977,-18,33,64,-49,36,-98,-1.7839445,3.329969728,6.25,-4.503676471,3.464870067,-9.11627907
706,428,948,997,988,1016,1141,1209,1274,49,-9,28,125,68,65,5.168776371,-0.902708124,2.834008097,12.30314961,5.959684487,5.376344086
707,827,770,942,982,969,964,942,950,172,40,-13,-5,-22,8,22.33766234,4.246284501,-1.323828921,-0.515995872,-2.282157676,0.8492569
708,852,1039,1077,1109,1093,1161,1134,1140,38,32,-16,68,-27,6,3.657362849,2.971216342,-1.442741208,6.221408966,-2.325581395,0.529100529
709,1901,949,800,761,766,798,920,864,-149,-39,5,32,122,-56,-15.70073762,-4.875,0.657030223,4.177545692,15.28822055,-6.086956522
710,974,1196,1188,1217,1255,1231,1266,1278,-8,29,38,-24,35,12,-0.668896321,2.441077441,3.12243221,-1.912350598,2.843216897,0.947867299
711,1190,1475,1537,1597,1697,1675,1698,1701,62,60,100,-22,23,3,4.203389831,3.903708523,6.261740764,-1.296405421,1.373134328,0.176678445
712,1339,1380,1409,1398,1233,1254,1135,1184,29,-11,-165,21,-119,49,2.101449275,-0.780695529,-11.80257511,1.703163017,-9.489633174,4.317180617
713,2848,977,923,970,1004,1036,1113,1099,-54,47,34,32,77,-14,-5.527123849,5.092091008,3.505154639,3.187250996,7.432432432,-1.257861635
714,360,1220,1262,1341,1330,1389,1435,1492,42,79,-11,59,46,57,3.442622951,6.259904913,-0.820283371,4.436090226,3.311735061,3.972125436
715,1337,1624,1701,1738,1737,1756,1799,1840,77,37,-1,19,43,41,4.74137931,2.175191064,-0.057537399,1.093839954,2.448747153,2.279043913
716,1689,1494,1713,1709,1875,1933,2105,1951,219,-4,166,58,172,-154,14.65863454,-0.233508465,9.713282621,3.093333333,8.898085877,-7.315914489
717,246,916,1174,1238,1228,1275,1307,1340,258,64,-10,47,32,33,28.16593886,5.451448041,-0.807754443,3.827361564,2.509803922,2.524866106
718,252,1203,1209,1181,1212,1225,1253,1272,6,-28,31,13,28,19,0.498753117,-2.315963606,2.624894157,1.072607261,2.285714286,1.516360734
719,922,1442,1487,1519,1511,1584,1498,1489,45,32,-8,73,-86,-9,3.120665742,2.15198386,-0.526662278,4.831237591,-5.429292929,-0.600801068
720,247,1440,1417,1431,1452,1456,1548,1573,-23,14,21,4,92,25,-1.597222222,0.988002823,1.467505241,0.275482094,6.318681319,1.61498708
721,260,1015,1125,1017,1083,1118,1141,1226,110,-108,66,35,23,85,10.83743842,-9.6,6.489675516,3.23176362,2.057245081,7.449605609
722,44,1194,1215,1228,1211,1254,1249,1250,21,13,-17,43,-5,1,1.75879397,1.069958848,-1.384364821,3.550784476,-0.398724083,0.080064051
723,1532,1266,1253,1257,1290,1319,1353,1418,-13,4,33,29,34,65,-1.02685624,0.319233839,2.625298329,2.248062016,2.577710387,4.80413895
724,518,855,877,937,939,957,959,965,22,60,2,18,2,6,2.573099415,6.841505131,0.213447172,1.916932907,0.208986416,0.625651721
725,917,795,933,990,993,877,948,1027,138,57,3,-116,71,79,17.35849057,6.109324759,0.303030303,-11.68177241,8.095781072,8.333333333
726,866,1449,1496,1531,1530,1487,1487,1549,47,35,-1,-43,0,62,3.243616287,2.339572193,-0.065316786,-2.810457516,0,4.169468729
727,978,1200,1204,1246,1279,1266,1289,1269,4,42,33,-13,23,-20,0.333333333,3.488372093,2.64847512,-1.016419077,1.816745656,-1.55159038
728,11,1696,1708,1747,1916,2030,2241,2400,12,39,169,114,211,159,0.70754717,2.283372365,9.673726388,5.949895616,10.39408867,7.095046854
729,2406,670,694,856,828,890,836,749,24,162,-28,62,-54,-87,3.582089552,23.34293948,-3.271028037,7.487922705,-6.06741573,-10.40669856
730,274,1262,1206,1085,1093,1145,1091,1150,-56,-121,8,52,-54,59,-4.437400951,-10.0331675,0.737327189,4.757548033,-4.716157205,5.407882676
731,5,1746,1710,1763,1934,2150,2304,2397,-36,53,171,216,154,93,-2.06185567,3.099415205,9.699376064,11.16856256,7.162790698,4.036458333
732,2981,863,854,900,925,950,1002,992,-9,46,25,25,52,-10,-1.042873696,5.386416862,2.777777778,2.702702703,5.473684211,-0.998003992
733,2544,1018,1046,1104,1153,1204,1325,1321,28,58,49,51,121,-4,2.750491159,5.544933078,4.438405797,4.423243712,10.04983389,-0.301886792
734,176,1250,1335,1392,1451,1474,1548,1670,85,57,59,23,74,122,6.8,4.269662921,4.238505747,1.585113715,5.020352782,7.881136951
735,687,1277,1157,1228,1113,1273,1326,1412,-120,71,-115,160,53,86,-9.397024276,6.136560069,-9.364820847,14.37556155,4.163393559,6.485671192
736,489,845,851,831,816,805,848,951,6,-20,-15,-11,43,103,0.710059172,-2.350176263,-1.805054152,-1.348039216,5.341614907,12.14622642
737,2026,999,940,984,1031,1054,1099,1105,-59,44,47,23,45,6,-5.905905906,4.680851064,4.776422764,2.230843841,4.269449715,0.545950864
738,1862,1236,1215,1207,1298,1300,1346,1371,-21,-8,91,2,46,25,-1.699029126,-0.658436214,7.53935377,0.154083205,3.538461538,1.857355126
739,2027,871,835,817,812,812,804,850,-36,-18,-5,0,-8,46,-4.133180253,-2.155688623,-0.611995104,0,-0.985221675,5.721393035
740,522,1046,981,988,1025,1080,1101,1103,-65,7,37,55,21,2,-6.21414914,0.713557594,3.744939271,5.365853659,1.944444444,0.181653043
741,111,933,1044,1088,1150,1132,1188,1187,111,44,62,-18,56,-1,11.89710611,4.214559387,5.698529412,-1.565217391,4.946996466,-0.084175084
742,1411,1185,1065,1009,786,1045,1127,1179,-120,-56,-223,259,82,52,-10.12658228,-5.258215962,-22.10109019,32.95165394,7.846889952,4.614019521
743,918,1002,973,968,1003,984,1003,1085,-29,-5,35,-19,19,82,-2.894211577,-0.513874615,3.615702479,-1.894317049,1.930894309,8.175473579
744,1342,1218,1032,955,956,1051,908,1143,-186,-77,1,95,-143,235,-15.27093596,-7.46124031,0.104712042,9.937238494,-13.60608944,25.88105727
745,1338,1275,1274,1299,884,1057,1054,1061,-1,25,-415,173,-3,7,-0.078431373,1.962323391,-31.94765204,19.57013575,-0.283822138,0.664136622
746,2904,889,899,930,1024,952,1074,1166,10,31,94,-72,122,92,1.124859393,3.448275862,10.10752688,-7.03125,12.81512605,8.566108007
747,1663,799,784,773,821,836,845,811,-15,-11,48,15,9,-34,-1.877346683,-1.403061224,6.209573092,1.827040195,1.076555024,-4.023668639
748,1247,1189,1175,1360,1456,1388,1433,1364,-14,185,96,-68,45,-69,-1.17746005,15.74468085,7.058823529,-4.67032967,3.242074928,-4.815073273
749,1548,1109,1198,1068,1201,1255,1341,1340,89,-130,133,54,86,-1,8.025247971,-10.85141903,12.45318352,4.496253122,6.852589641,-0.074571216
750,1370,1173,1161,1243,1199,1247,1226,1190,-12,82,-44,48,-21,-36,-1.023017903,7.06287683,-3.539823009,4.003336113,-1.6840417,-2.936378467
751,1640,1130,994,960,1039,1031,1086,1133,-136,-34,79,-8,55,47,-12.03539823,-3.420523139,8.229166667,-0.769971126,5.334626576,4.327808471
752,499,1325,1102,1086,1081,1187,1226,1348,-223,-16,-5,106,39,122,-16.83018868,-1.451905626,-0.460405157,9.80573543,3.285593934,9.951060359
753,2466,1211,1133,1136,1174,1210,1273,1337,-78,3,38,36,63,64,-6.440957886,0.26478376,3.345070423,3.066439523,5.20661157,5.027494108
754,1218,1222,1111,1161,1204,1226,1279,1338,-111,50,43,22,53,59,-9.083469722,4.500450045,3.703703704,1.827242525,4.323001631,4.61297889
755,1177,1689,1646,1707,1770,1779,1811,1794,-43,61,63,9,32,-17,-2.545885139,3.705953827,3.690685413,0.508474576,1.79876335,-0.938707896
756,95,1182,1133,1153,1140,1193,1149,1216,-49,20,-13,53,-44,67,-4.145516074,1.765225066,-1.127493495,4.649122807,-3.688181056,5.831157528
757,1958,929,862,874,853,833,874,839,-67,12,-21,-20,41,-35,-7.212055974,1.392111369,-2.402745995,-2.344665885,4.921968788,-4.004576659
758,187,1138,1171,1150,1148,1155,1181,1237,33,-21,-2,7,26,56,2.899824253,-1.793339026,-0.173913043,0.609756098,2.251082251,4.741744285
759,2404,835,856,893,932,911,939,1085,21,37,39,-21,28,146,2.51497006,4.322429907,4.367301232,-2.253218884,3.073545554,15.5484558
760,1884,1012,961,974,978,960,900,936,-51,13,4,-18,-60,36,-5.039525692,1.352757544,0.410677618,-1.840490798,-6.25,4
761,2299,921,927,915,937,934,993,940,6,-12,22,-3,59,-53,0.651465798,-1.294498382,2.404371585,-0.320170758,6.316916488,-5.337361531
762,1870,1250,1209,1217,1270,1274,1283,1288,-41,8,53,4,9,5,-3.28,0.661703888,4.354971241,0.31496063,0.706436421,0.389711613
763,159,1063,1080,1004,1092,1183,1249,1280,17,-76,88,91,66,31,1.599247413,-7.037037037,8.764940239,8.333333333,5.579036348,2.481985588
764,88,1219,1089,1041,1097,1105,1138,1182,-130,-48,56,8,33,44,-10.66447908,-4.407713499,5.379442843,0.729261623,2.986425339,3.866432337
765,449,1010,1019,1048,1093,1091,1166,1161,9,29,45,-2,75,-5,0.891089109,2.84592738,4.29389313,-0.182982617,6.874427131,-0.428816467
766,1050,1314,1418,1530,1583,1420,1418,1389,104,112,53,-163,-2,-29,7.914764079,7.898448519,3.464052288,-10.29690461,-0.14084507,-2.045133992
767,1130,1086,1002,1160,1157,1101,1097,1134,-84,158,-3,-56,-4,37,-7.73480663,15.76846307,-0.25862069,-4.840103717,-0.363306085,3.372835005
768,133,1098,1102,1130,1132,1194,1220,1327,4,28,2,62,26,107,0.364298725,2.540834846,0.17699115,5.477031802,2.177554439,8.770491803
769,2129,951,925,918,931,935,956,948,-26,-7,13,4,21,-8,-2.733964248,-0.756756757,1.416122004,0.429645542,2.245989305,-0.836820084
770,1387,1154,976,907,988,1007,929,1130,-178,-69,81,19,-78,201,-15.42461005,-7.069672131,8.930540243,1.923076923,-7.745779543,21.63616792
771,151,1328,1376,1437,1458,1583,1708,1733,48,61,21,125,125,25,3.614457831,4.433139535,1.461377871,8.573388203,7.896399242,1.463700234
772,2105,856,826,852,852,847,849,871,-30,26,0,-5,2,22,-3.504672897,3.147699758,0,-0.58685446,0.236127509,2.591283863
773,989,1011,1048,1073,1098,1041,1152,1254,37,25,25,-57,111,102,3.659742829,2.385496183,2.329916123,-5.191256831,10.66282421,8.854166667
774,745,1290,1234,1207,1166,1158,1154,1224,-56,-27,-41,-8,-4,70,-4.341085271,-2.188006483,-3.396851698,-0.686106346,-0.345423143,6.065857886
775,397,876,900,886,923,911,853,811,24,-14,37,-12,-58,-42,2.739726027,-1.555555556,4.176072235,-1.300108342,-6.366630077,-4.923798359
776,1406,1116,1027,1111,1166,1170,1047,1022,-89,84,55,4,-123,-25,-7.974910394,8.17916261,4.95049505,0.343053173,-10.51282051,-2.387774594
777,1539,931,925,944,923,935,907,934,-6,19,-21,12,-28,27,-0.644468314,2.054054054,-2.224576271,1.300108342,-2.994652406,2.976846748
778,486,922,891,959,1107,966,1036,990,-31,68,148,-141,70,-46,-3.362255965,7.631874299,15.43274244,-12.73712737,7.246376812,-4.44015444
779,1557,850,825,791,870,857,839,847,-25,-34,79,-13,-18,8,-2.941176471,-4.121212121,9.987357775,-1.494252874,-2.100350058,0.953516091
780,2726,983,895,904,884,880,904,906,-88,9,-20,-4,24,2,-8.952187182,1.005586592,-2.212389381,-0.452488688,2.727272727,0.221238938
781,1627,752,769,758,777,767,773,736,17,-11,19,-10,6,-37,2.260638298,-1.430429129,2.506596306,-1.287001287,0.782268579,-4.786545925
782,817,1327,1246,1251,1306,1308,1344,1357,-81,5,55,2,36,13,-6.103993971,0.401284109,4.396482814,0.153139357,2.752293578,0.967261905
783,590,696,755,745,726,775,835,808,59,-10,-19,49,60,-27,8.477011494,-1.324503311,-2.55033557,6.749311295,7.741935484,-3.233532934
784,2165,895,1138,1036,911,997,1017,972,243,-102,-125,86,20,-45,27.15083799,-8.963093146,-12.06563707,9.440175631,2.006018054,-4.424778761
785,1417,1025,1177,1174,1191,1233,1240,1293,152,-3,17,42,7,53,14.82926829,-0.254885302,1.448040886,3.526448363,0.567721006,4.274193548
786,303,1200,1196,1179,1053,1017,1061,1068,-4,-17,-126,-36,44,7,-0.333333333,-1.421404682,-10.6870229,-3.418803419,4.326450344,0.659754948
787,1183,1250,1105,1174,1321,1476,1575,1657,-145,69,147,155,99,82,-11.6,6.244343891,12.52129472,11.7335352,6.707317073,5.206349206
788,1750,1089,1111,1078,1102,1123,1138,1140,22,-33,24,21,15,2,2.02020202,-2.97029703,2.226345083,1.905626134,1.335707925,0.175746924
789,1654,1276,1281,1270,1299,1216,1194,1114,5,-11,29,-83,-22,-80,0.39184953,-0.858704137,2.283464567,-6.389530408,-1.809210526,-6.700167504
790,1395,1056,943,921,1069,1100,1050,1133,-113,-22,148,31,-50,83,-10.70075758,-2.332979852,16.06948969,2.899906455,-4.545454545,7.904761905
791,541,905,905,980,925,927,951,949,0,75,-55,2,24,-2,0,8.287292818,-5.612244898,0.216216216,2.588996764,-0.210304942
792,2721,876,881,922,944,895,916,920,5,41,22,-49,21,4,0.570776256,4.653802497,2.386117137,-5.190677966,2.346368715,0.436681223
793,2505,1073,1080,1098,1150,1189,1236,1202,7,18,52,39,47,-34,0.652376514,1.666666667,4.735883424,3.391304348,3.952901598,-2.750809061
794,136,1291,1309,1306,1312,1387,1391,1410,18,-3,6,75,4,19,1.394268009,-0.229182582,0.45941807,5.716463415,0.288392213,1.365923796
795,1364,1110,872,849,902,928,1019,953,-238,-23,53,26,91,-66,-21.44144144,-2.637614679,6.242638398,2.88248337,9.806034483,-6.476938175
796,533,859,859,883,884,870,856,861,0,24,1,-14,-14,5,0,2.793946449,0.113250283,-1.583710407,-1.609195402,0.58411215
797,1226,1152,1140,1142,1176,1191,1201,1199,-12,2,34,15,10,-2,-1.041666667,0.175438596,2.977232925,1.275510204,0.839630563,-0.166527893
798,2088,1088,1066,1045,1224,1163,1251,1295,-22,-21,179,-61,88,44,-2.022058824,-1.969981238,17.1291866,-4.983660131,7.566638005,3.517186251
799,1606,1005,1022,1043,1110,1125,1154,1188,17,21,67,15,29,34,1.691542289,2.054794521,6.423777565,1.351351351,2.577777778,2.94627383
800,823,1355,1411,1456,1446,1475,1341,1345,56,45,-10,29,-134,4,4.132841328,3.189227498,-0.686813187,2.005532503,-9.084745763,0.298284862
801,453,1127,1097,1000,963,1013,1008,1063,-30,-97,-37,50,-5,55,-2.661934339,-8.842297174,-3.7,5.192107996,-0.493583416,5.456349206
802,1915,1050,1069,1120,1005,894,902,902,19,51,-115,-111,8,0,1.80952381,4.770813845,-10.26785714,-11.04477612,0.894854586,0
803,1112,1166,1140,1263,1221,1238,1296,1253,-26,123,-42,17,58,-43,-2.229845626,10.78947368,-3.325415677,1.392301392,4.684975767,-3.317901235
804,169,1157,1064,1042,1144,1169,1159,1178,-93,-22,102,25,-10,19,-8.038029386,-2.067669173,9.788867562,2.185314685,-0.855431993,1.639344262
805,1470,953,991,1054,1038,1051,1013,1009,38,63,-16,13,-38,-4,3.987408185,6.357214934,-1.518026565,1.252408478,-3.615604186,-0.394866732
806,245,1100,1083,950,1133,1190,1222,1227,-17,-133,183,57,32,5,-1.545454545,-12.28070175,19.26315789,5.030891439,2.68907563,0.409165303
807,1822,1097,1042,1052,1096,1146,1118,1130,-55,10,44,50,-28,12,-5.013673655,0.959692898,4.182509506,4.562043796,-2.443280977,1.073345259
808,2140,1043,994,995,1045,1060,1046,1095,-49,1,50,15,-14,49,-4.697986577,0.100603622,5.025125628,1.435406699,-1.320754717,4.684512428
809,2169,1205,1365,1204,1219,1176,1361,1286,160,-161,15,-43,185,-75,13.2780083,-11.79487179,1.245847176,-3.527481542,15.73129252,-5.510653931
810,571,950,934,950,965,1094,1075,1105,-16,16,15,129,-19,30,-1.684210526,1.713062099,1.578947368,13.36787565,-1.736745887,2.790697674
811,440,919,843,895,942,996,990,1042,-76,52,47,54,-6,52,-8.269858542,6.168446026,5.251396648,5.732484076,-0.602409639,5.252525253
812,734,1041,1033,1025,1034,1118,1177,1177,-8,-8,9,84,59,0,-0.768491835,-0.774443369,0.87804878,8.123791103,5.277280859,0
813,1859,1122,1159,1068,1110,1150,1201,1198,37,-91,42,40,51,-3,3.297682709,-7.851596204,3.93258427,3.603603604,4.434782609,-0.24979184
814,1134,1021,980,933,988,996,999,1041,-41,-47,55,8,3,42,-4.015670911,-4.795918367,5.894962487,0.809716599,0.301204819,4.204204204
815,628,1100,1107,1146,1182,1294,1313,1321,7,39,36,112,19,8,0.636363636,3.52303523,3.141361257,9.475465313,1.468315301,0.609291698
816,1691,948,888,922,922,942,925,972,-60,34,0,20,-17,47,-6.329113924,3.828828829,0,2.169197397,-1.804670913,5.081081081
817,2533,1050,1093,1107,1171,1146,1103,1129,43,14,64,-25,-43,26,4.095238095,1.280878317,5.781391147,-2.134927412,-3.752181501,2.357207616
818,2133,933,750,875,846,829,814,798,-183,125,-29,-17,-15,-16,-19.61414791,16.66666667,-3.314285714,-2.009456265,-1.809408926,-1.965601966
819,332,947,1025,1045,1031,1086,1146,1224,78,20,-14,55,60,78,8.236536431,1.951219512,-1.339712919,5.334626576,5.524861878,6.806282723
820,222,1559,1541,1496,1480,1509,1603,1577,-18,-45,-16,29,94,-26,-1.154586273,-2.9201817,-1.069518717,1.959459459,6.229290921,-1.621958827
821,2337,988,951,991,1021,1094,1148,1126,-37,40,30,73,54,-22,-3.744939271,4.206098843,3.027245207,7.149853085,4.936014625,-1.916376307
822,1984,1216,1202,1223,1228,1111,1146,1141,-14,21,5,-117,35,-5,-1.151315789,1.747088186,0.408830744,-9.527687296,3.150315032,-0.436300175
823,2365,754,780,749,792,798,809,846,26,-31,43,6,11,37,3.448275862,-3.974358974,5.740987984,0.757575758,1.378446115,4.57354759
824,1266,1479,1439,1365,1459,1556,1577,1614,-40,-74,94,97,21,37,-2.704530088,-5.142460042,6.886446886,6.648389308,1.349614396,2.346227013
825,1871,1486,1461,1430,1535,1463,1562,1534,-25,-31,105,-72,99,-28,-1.682368775,-2.12183436,7.342657343,-4.690553746,6.766917293,-1.792573624
826,878,994,1016,1154,1116,1206,1231,1233,22,138,-38,90,25,2,2.213279678,13.58267717,-3.292894281,8.064516129,2.072968491,0.162469537
827,1727,1163,1154,1142,1127,1022,1051,999,-9,-12,-15,-105,29,-52,-0.773860705,-1.039861352,-1.313485114,-9.316770186,2.837573386,-4.947668887
828,1769,852,847,872,828,829,838,876,-5,25,-44,1,9,38,-0.58685446,2.951593861,-5.04587156,0.120772947,1.085645356,4.534606205
829,632,903,893,919,966,1028,1035,1038,-10,26,47,62,7,3,-1.107419712,2.911534155,5.114254625,6.418219462,0.680933852,0.289855072
830,675,924,908,901,1013,1091,985,967,-16,-7,112,78,-106,-18,-1.731601732,-0.77092511,12.43063263,7.699901283,-9.715857012,-1.827411168
831,1936,996,997,1003,1020,1122,1186,1197,1,6,17,102,64,11,0.100401606,0.601805416,1.694915254,10,5.704099822,0.927487352
832,480,822,936,983,1002,995,1026,1012,114,47,19,-7,31,-14,13.86861314,5.021367521,1.932858596,-0.698602794,3.115577889,-1.364522417
833,150,1100,1006,918,1042,1087,1055,1085,-94,-88,124,45,-32,30,-8.545454545,-8.747514911,13.50762527,4.318618042,-2.943882245,2.843601896
834,2261,1618,1438,1375,1390,1298,1382,1431,-180,-63,15,-92,84,49,-11.12484549,-4.38108484,1.090909091,-6.618705036,6.471494607,3.545586107
835,1,2138,2142,2141,2231,2341,2447,2561,4,-1,90,110,106,114,0.187090739,-0.046685341,4.203643157,4.930524429,4.527979496,4.658765836
836,608,970,960,1054,1033,1073,1080,1106,-10,94,-21,40,7,26,-1.030927835,9.791666667,-1.992409867,3.872216844,0.652376514,2.407407407
837,146,2123,2192,2205,2272,2264,2306,2304,69,13,67,-8,42,-2,3.250117758,0.593065693,3.038548753,-0.352112676,1.855123675,-0.086730269
838,762,1219,1283,1288,1322,1259,1342,1349,64,5,34,-63,83,7,5.250205086,0.389711613,2.639751553,-4.765506808,6.592533757,0.521609538
839,1082,690,717,761,823,794,851,829,27,44,62,-29,57,-22,3.913043478,6.136680614,8.14717477,-3.523693803,7.17884131,-2.58519389
840,1350,1070,953,949,985,970,959,962,-117,-4,36,-15,-11,3,-10.93457944,-0.419727177,3.793466807,-1.52284264,-1.134020619,0.31282586
841,1481,1113,1171,978,1073,1105,1026,1132,58,-193,95,32,-79,106,5.21114106,-16.48163962,9.713701431,2.982292637,-7.149321267,10.33138402
842,1224,1089,1008,1133,1141,1180,1195,1189,-81,125,8,39,15,-6,-7.438016529,12.40079365,0.706090026,3.418054338,1.271186441,-0.50209205
843,107,825,881,793,836,905,911,900,56,-88,43,69,6,-11,6.787878788,-9.988649262,5.422446406,8.253588517,0.662983425,-1.207464325
844,1730,1190,1119,972,1095,1156,1192,1317,-71,-147,123,61,36,125,-5.966386555,-13.13672922,12.65432099,5.570776256,3.114186851,10.48657718
845,1799,900,923,873,884,875,877,852,23,-50,11,-9,2,-25,2.555555556,-5.417118093,1.26002291,-1.018099548,0.228571429,-2.850627138
846,335,1150,1133,1146,1053,1183,1008,1042,-17,13,-93,130,-175,34,-1.47826087,1.147396293,-8.115183246,12.34567901,-14.79289941,3.373015873
847,452,1034,870,885,946,935,916,978,-164,15,61,-11,-19,62,-15.86073501,1.724137931,6.892655367,-1.162790698,-2.032085561,6.768558952
848,1973,941,1054,949,1007,1024,1089,1079,113,-105,58,17,65,-10,12.00850159,-9.962049336,6.111696523,1.688182721,6.34765625,-0.918273646
849,578,1120,971,924,964,974,1052,1199,-149,-47,40,10,78,147,-13.30357143,-4.840370752,4.329004329,1.037344398,8.008213552,13.97338403
850,1959,1186,1011,1088,972,1001,1141,1038,-175,77,-116,29,140,-103,-14.75548061,7.616221563,-10.66176471,2.983539095,13.98601399,-9.02716915
851,1173,1106,1178,1197,1217,1199,1232,1250,72,19,20,-18,33,18,6.50994575,1.612903226,1.670843776,-1.479046836,2.752293578,1.461038961
852,2292,907,900,912,890,886,862,892,-7,12,-22,-4,-24,30,-0.771775083,1.333333333,-2.412280702,-0.449438202,-2.708803612,3.480278422
853,755,901,958,956,994,1043,959,1018,57,-2,38,49,-84,59,6.326304107,-0.208768267,3.974895397,4.929577465,-8.053691275,6.152241919
854,1542,1200,1093,1174,1172,1061,1046,1021,-107,81,-2,-111,-15,-25,-8.916666667,7.410795974,-0.170357751,-9.470989761,-1.413760603,-2.390057361
855,277,1321,1267,1104,1151,1155,1166,1221,-54,-163,47,4,11,55,-4.087812263,-12.86503552,4.257246377,0.347523892,0.952380952,4.716981132
856,138,1070,1115,1092,1103,1064,1132,1108,45,-23,11,-39,68,-24,4.205607477,-2.062780269,1.007326007,-3.535811423,6.390977444,-2.120141343
857,2074,844,857,924,954,939,937,942,13,67,30,-15,-2,5,1.54028436,7.817969662,3.246753247,-1.572327044,-0.212992545,0.53361793
858,1754,959,940,946,946,959,948,969,-19,6,0,13,-11,21,-1.981230448,0.638297872,0,1.374207188,-1.147028154,2.215189873
859,987,1200,1245,1179,1118,1162,1218,1181,45,-66,-61,44,56,-37,3.75,-5.301204819,-5.173876166,3.935599284,4.819277108,-3.037766831
860,1230,1200,872,939,895,907,934,934,-328,67,-44,12,27,0,-27.33333333,7.683486239,-4.685835996,1.340782123,2.976846748,0
861,1317,850,759,720,834,796,789,791,-91,-39,114,-38,-7,2,-10.70588235,-5.138339921,15.83333333,-4.556354916,-0.879396985,0.253485425
862,426,928,931,891,891,896,945,1072,3,-40,0,5,49,127,0.323275862,-4.296455424,0,0.561167228,5.46875,13.43915344
863,913,978,1051,1067,1103,1127,1184,1181,73,16,36,24,57,-3,7.464212679,1.522359657,3.373945642,2.175883953,5.057675244,-0.253378378
864,658,1088,1009,1014,1083,1104,1148,1162,-79,5,69,21,44,14,-7.261029412,0.495540139,6.804733728,1.939058172,3.985507246,1.219512195
865,381,904,828,788,838,897,850,922,-76,-40,50,59,-47,72,-8.407079646,-4.830917874,6.345177665,7.040572792,-5.239687848,8.470588235
866,2307,1036,1036,1038,1098,1143,1152,1145,0,2,60,45,9,-7,0,0.193050193,5.780346821,4.098360656,0.787401575,-0.607638889
867,1028,1203,1279,1266,1339,1318,1324,1331,76,-13,73,-21,6,7,6.317539485,-1.016419077,5.766192733,-1.568334578,0.455235205,0.528700906
868,181,766,600,780,767,757,838,811,-166,180,-13,-10,81,-27,-21.67101828,30,-1.666666667,-1.303780965,10.7001321,-3.221957041
869,712,1504,1633,1657,1680,1680,1749,1774,129,24,23,0,69,25,8.57712766,1.469687691,1.388050694,0,4.107142857,1.429388222
870,1006,1342,1439,1568,1540,1646,1652,1704,97,129,-28,106,6,52,7.228017884,8.964558721,-1.785714286,6.883116883,0.364520049,3.147699758
871,1211,1434,1411,1471,1525,1582,1627,1702,-23,60,54,57,45,75,-1.60390516,4.252303331,3.670972128,3.737704918,2.844500632,4.609711125
872,1806,1023,877,869,898,889,954,944,-146,-8,29,-9,65,-10,-14.27174976,-0.912200684,3.33716916,-1.002227171,7.311586052,-1.048218029
873,431,768,900,898,917,884,913,950,132,-2,19,-33,29,37,17.1875,-0.222222222,2.115812918,-3.598691385,3.280542986,4.052573932
874,2,1200,1165,1196,1201,1233,1287,1343,-35,31,5,32,54,56,-2.916666667,2.660944206,0.418060201,2.664446295,4.379562044,4.351204351
875,174,2884,3075,3243,3218,3957,4096,4229,191,168,-25,739,139,133,6.622746186,5.463414634,-0.77089115,22.96457427,3.512762194,3.247070313
876,676,760,917,971,956,886,902,927,157,54,-15,-70,16,25,20.65789474,5.888767721,-1.544799176,-7.322175732,1.805869074,2.771618625
877,1909,799,804,843,913,902,887,945,5,39,70,-11,-15,58,0.625782228,4.850746269,8.303677343,-1.204819277,-1.662971175,6.538895152
878,1210,879,861,890,939,992,1002,1062,-18,29,49,53,10,60,-2.04778157,3.368176539,5.505617978,5.644302449,1.008064516,5.988023952
879,760,1086,1028,1046,1057,1146,1130,1115,-58,18,11,89,-16,-15,-5.340699816,1.750972763,1.051625239,8.420056764,-1.396160558,-1.327433628
880,1171,1009,967,982,1054,1065,1073,1099,-42,15,72,11,8,26,-4.162537166,1.551189245,7.33197556,1.043643264,0.751173709,2.423112768
881,487,750,798,828,817,840,846,853,48,30,-11,23,6,7,6.4,3.759398496,-1.328502415,2.815177479,0.714285714,0.827423168
882,145,997,1055,1106,1161,1264,1341,1448,58,51,55,103,77,107,5.817452357,4.834123223,4.972875226,8.87166236,6.091772152,7.97912006
883,1752,970,915,957,968,1001,1031,1042,-55,42,11,33,30,11,-5.670103093,4.590163934,1.149425287,3.409090909,2.997002997,1.066925315
884,2350,1211,1200,1154,1262,1210,1311,1284,-11,-46,108,-52,101,-27,-0.908340215,-3.833333333,9.358752166,-4.12044374,8.347107438,-2.059496568
885,1494,924,902,925,936,918,914,895,-22,23,11,-18,-4,-19,-2.380952381,2.549889135,1.189189189,-1.923076923,-0.435729847,-2.078774617
886,945,1540,1456,1413,1357,1419,1424,1460,-84,-43,-56,62,5,36,-5.454545455,-2.953296703,-3.963198868,4.56890199,0.352360817,2.528089888
887,396,885,888,837,865,886,948,922,3,-51,28,21,62,-26,0.338983051,-5.743243243,3.345280765,2.427745665,6.997742664,-2.742616034
888,2324,1231,1230,1262,1224,1146,1149,1080,-1,32,-38,-78,3,-69,-0.081234768,2.601626016,-3.011093502,-6.37254902,0.261780105,-6.005221932
889,1551,1034,966,940,954,1052,1085,1118,-68,-26,14,98,33,33,-6.576402321,-2.691511387,1.489361702,10.27253669,3.136882129,3.041474654
890,2874,675,732,831,835,946,887,788,57,99,4,111,-59,-99,8.444444444,13.52459016,0.481347774,13.29341317,-6.236786469,-11.16121759
891,1719,1026,1006,919,858,917,947,1029,-20,-87,-61,59,30,82,-1.949317739,-8.648111332,-6.637649619,6.876456876,3.271537623,8.658922914
892,983,909,931,942,975,865,905,884,22,11,33,-110,40,-21,2.420242024,1.181525242,3.503184713,-11.28205128,4.624277457,-2.320441989
893,766,861,894,870,936,947,894,808,33,-24,66,11,-53,-86,3.832752613,-2.684563758,7.586206897,1.175213675,-5.596620908,-9.619686801
894,1297,1335,1417,1486,1539,1666,1734,1768,82,69,53,127,68,34,6.142322097,4.869442484,3.566621803,8.252111761,4.081632653,1.960784314
895,2051,880,919,904,961,885,911,885,39,-15,57,-76,26,-26,4.431818182,-1.632208923,6.305309735,-7.90842872,2.937853107,-2.854006586
896,1020,807,842,787,881,856,868,802,35,-55,94,-25,12,-66,4.337050805,-6.532066508,11.94409149,-2.837684449,1.401869159,-7.603686636
897,1742,1100,941,968,944,928,984,1003,-159,27,-24,-16,56,19,-14.45454545,2.869287991,-2.479338843,-1.694915254,6.034482759,1.930894309
898,523,1242,1028,1018,1074,1107,1102,1152,-214,-10,56,33,-5,50,-17.23027375,-0.972762646,5.500982318,3.072625698,-0.451671183,4.537205082
899,1089,1327,1417,1394,1425,1473,1529,1465,90,-23,31,48,56,-64,6.782215524,-1.623147495,2.223816356,3.368421053,3.801765105,-4.185742315
900,1404,958,892,941,963,1005,1088,1142,-66,49,22,42,83,54,-6.889352818,5.493273543,2.337938363,4.361370717,8.258706468,4.963235294
901,2167,898,914,934,980,1097,1140,1153,16,20,46,117,43,13,1.781737194,2.188183807,4.925053533,11.93877551,3.919781222,1.140350877
902,683,893,871,854,902,906,971,977,-22,-17,48,4,65,6,-2.463605823,-1.951779564,5.620608899,0.44345898,7.174392936,0.61791967
903,748,994,956,1030,1151,1137,1106,1101,-38,74,121,-14,-31,-5,-3.822937626,7.740585774,11.74757282,-1.216333623,-2.726473175,-0.452079566
904,1072,1200,1440,1408,1396,1295,1293,1292,240,-32,-12,-101,-2,-1,20,-2.222222222,-0.852272727,-7.23495702,-0.154440154,-0.07733952
905,1460,953,924,890,896,980,953,989,-29,-34,6,84,-27,36,-3.043022036,-3.67965368,0.674157303,9.375,-2.755102041,3.777544596
906,2399,1000,979,995,963,1045,1106,1022,-21,16,-32,82,61,-84,-2.1,1.634320735,-3.216080402,8.515057113,5.837320574,-7.594936709
907,1215,1526,1496,1535,1534,1595,1621,1638,-30,39,-1,61,26,17,-1.965923984,2.606951872,-0.06514658,3.976531943,1.630094044,1.048735349
908,2104,1238,1257,1027,1062,1121,1129,1103,19,-230,35,59,8,-26,1.534733441,-18.29753381,3.407984421,5.555555556,0.713648528,-2.302922941
909,656,1052,1010,1008,1006,978,962,967,-42,-2,-2,-28,-16,5,-3.992395437,-0.198019802,-0.198412698,-2.783300199,-1.63599182,0.51975052
910,1243,1138,1092,982,1050,1075,1087,1169,-46,-110,68,25,12,82,-4.042179262,-10.07326007,6.924643585,2.380952381,1.11627907,7.543698252
911,1520,949,910,934,936,981,984,1039,-39,24,2,45,3,55,-4.109589041,2.637362637,0.214132762,4.807692308,0.305810398,5.589430894
912,2033,770,1025,1036,985,1070,1043,1046,255,11,-51,85,-27,3,33.11688312,1.073170732,-4.922779923,8.629441624,-2.523364486,0.287631831
913,806,1032,1064,978,911,994,1008,968,32,-86,-67,83,14,-40,3.100775194,-8.082706767,-6.850715746,9.110867179,1.408450704,-3.968253968
914,36,1093,1122,1173,1213,1253,1292,1350,29,51,40,40,39,58,2.653247941,4.545454545,3.410059676,3.297609233,3.112529928,4.489164087
915,773,1164,1169,1204,1272,1097,1226,1178,5,35,68,-175,129,-48,0.429553265,2.994011976,5.647840532,-13.75786164,11.75934366,-3.915171289
916,238,1254,1253,1269,1423,1386,1507,1425,-1,16,154,-37,121,-82,-0.079744817,1.276935355,12.1355398,-2.600140548,8.73015873,-5.441274054
917,1559,1298,1183,1182,1257,1264,1336,1364,-115,-1,75,7,72,28,-8.859784284,-0.084530854,6.345177665,0.556881464,5.696202532,2.095808383
918,872,1197,1167,1147,1174,1225,1195,1205,-30,-20,27,51,-30,10,-2.506265664,-1.713796058,2.35396687,4.344122658,-2.448979592,0.836820084
919,2211,765,820,827,842,866,899,886,55,7,15,24,33,-13,7.189542484,0.853658537,1.813784764,2.850356295,3.810623557,-1.446051168
920,171,1158,967,991,1010,1055,1095,1193,-191,24,19,45,40,98,-16.49395509,2.481902792,1.917255298,4.455445545,3.791469194,8.949771689
921,2507,1200,1193,1213,1113,1078,1095,1104,-7,20,-100,-35,17,9,-0.583333333,1.676445935,-8.244023083,-3.144654088,1.576994434,0.821917808
922,1850,998,1036,987,949,961,945,1005,38,-49,-38,12,-16,60,3.80761523,-4.72972973,-3.850050659,1.264488936,-1.664932362,6.349206349
923,130,1653,1754,1746,1785,1782,1810,1867,101,-8,39,-3,28,57,6.110102843,-0.456100342,2.233676976,-0.168067227,1.571268238,3.149171271
924,688,976,1005,1027,1116,1124,1190,1110,29,22,89,8,66,-80,2.971311475,2.189054726,8.666017527,0.716845878,5.871886121,-6.722689076
925,1475,984,837,1069,861,736,683,792,-147,232,-208,-125,-53,109,-14.93902439,27.71804062,-19.45743686,-14.51800232,-7.201086957,15.95900439
926,1836,903,912,875,863,884,904,842,9,-37,-12,21,20,-62,0.996677741,-4.057017544,-1.371428571,2.433371958,2.262443439,-6.85840708
927,1296,1286,1405,1445,1472,1439,1528,1527,119,40,27,-33,89,-1,9.253499222,2.846975089,1.868512111,-2.241847826,6.184850591,-0.065445026
928,284,1265,1185,1174,1142,1141,1158,1190,-80,-11,-32,-1,17,32,-6.324110672,-0.928270042,-2.72572402,-0.087565674,1.489921122,2.763385147
929,2356,861,819,824,820,815,807,859,-42,5,-4,-5,-8,52,-4.87804878,0.610500611,-0.485436893,-0.609756098,-0.981595092,6.44361834
930,2018,783,719,737,737,752,745,771,-64,18,0,15,-7,26,-8.173690932,2.503477051,0,2.035278155,-0.930851064,3.489932886
931,1703,1143,1154,1172,1163,1266,1256,1253,11,18,-9,103,-10,-3,0.962379703,1.559792028,-0.767918089,8.856405847,-0.789889415,-0.238853503
932,361,991,939,906,1061,966,1055,991,-52,-33,155,-95,89,-64,-5.247225025,-3.514376997,17.10816777,-8.953817154,9.213250518,-6.066350711
933,1158,1538,1583,1647,1752,1826,1921,1981,45,64,105,74,95,60,2.925877763,4.042956412,6.375227687,4.223744292,5.202628697,3.123373243
934,248,1422,1514,1522,1514,1551,1634,1638,92,8,-8,37,83,4,6.4697609,0.528401585,-0.525624179,2.443857332,5.351386202,0.244798042
935,17,2001,2034,2130,2221,2315,2422,2500,33,96,91,94,107,78,1.649175412,4.719764012,4.272300469,4.23232778,4.622030238,3.220478943
936,46,1870,1858,1928,1887,2047,2030,2138,-12,70,-41,160,-17,108,-0.64171123,3.767491927,-2.126556017,8.479067303,-0.830483635,5.320197044
937,1058,1249,1343,1367,1407,1384,1396,1400,94,24,40,-23,12,4,7.526020817,1.787043931,2.926115582,-1.634683724,0.867052023,0.286532951
938,1393,1143,976,999,1054,977,1076,1071,-167,23,55,-77,99,-5,-14.61067367,2.356557377,5.505505506,-7.305502846,10.13306039,-0.464684015
939,623,938,964,1005,1028,1042,1012,1018,26,41,23,14,-30,6,2.771855011,4.253112033,2.288557214,1.361867704,-2.879078695,0.592885375
940,833,1189,1142,1211,1219,1202,1239,1298,-47,69,8,-17,37,59,-3.952901598,6.042031524,0.660611065,-1.394585726,3.078202995,4.761904762
941,655,799,822,867,818,862,876,864,23,45,-49,44,14,-12,2.878598248,5.474452555,-5.651672434,5.378973105,1.62412993,-1.369863014
942,996,1135,1230,1129,1043,1104,1151,1146,95,-101,-86,61,47,-5,8.370044053,-8.211382114,-7.617360496,5.848513902,4.257246377,-0.434404865
943,2038,924,924,941,982,974,995,975,0,17,41,-8,21,-20,0,1.83982684,4.35706695,-0.814663951,2.156057495,-2.010050251
944,2011,798,824,823,825,779,772,784,26,-1,2,-46,-7,12,3.258145363,-0.121359223,0.243013366,-5.575757576,-0.898587933,1.554404145
945,2213,903,860,868,866,866,824,892,-43,8,-2,0,-42,68,-4.761904762,0.930232558,-0.230414747,0,-4.849884527,8.252427184
946,1924,916,1002,982,1071,996,1050,1070,86,-20,89,-75,54,20,9.388646288,-1.996007984,9.063136456,-7.00280112,5.421686747,1.904761905
947,2368,1042,1033,1041,1119,1104,1165,979,-9,8,78,-15,61,-186,-0.863723608,0.774443369,7.492795389,-1.340482574,5.525362319,-15.96566524
948,118,910,918,850,892,899,955,933,8,-68,42,7,56,-22,0.879120879,-7.407407407,4.941176471,0.784753363,6.229143493,-2.303664921
949,1022,1224,1133,1200,1200,1157,1203,1232,-91,67,0,-43,46,29,-7.434640523,5.913503972,0,-3.583333333,3.975799481,2.410640067
950,213,1107,1037,1093,1101,1094,1010,1137,-70,56,8,-7,-84,127,-6.323396567,5.400192864,0.731930467,-0.635785649,-7.678244973,12.57425743
951,2845,795,844,826,829,887,889,897,49,-18,3,58,2,8,6.163522013,-2.132701422,0.363196126,6.996381182,0.225479143,0.899887514
952,68,1985,2060,2054,2212,2247,2270,2326,75,-6,158,35,23,56,3.778337531,-0.291262136,7.692307692,1.582278481,1.023587005,2.466960352
953,1008,1914,1814,1661,1700,1819,1942,1990,-100,-153,39,119,123,48,-5.224660397,-8.434399118,2.347983143,7,6.761957119,2.471678682
954,1698,1398,1321,1330,1310,1321,1361,1378,-77,9,-20,11,40,17,-5.507868383,0.681302044,-1.503759398,0.839694656,3.028009084,1.249081558
955,1310,1148,1056,1202,1179,1232,1198,1236,-92,146,-23,53,-34,38,-8.013937282,13.82575758,-1.913477537,4.49533503,-2.75974026,3.171953255
956,2740,795,780,794,789,804,764,829,-15,14,-5,15,-40,65,-1.886792453,1.794871795,-0.629722922,1.901140684,-4.975124378,8.507853403
957,55,1002,1260,1309,1313,1350,1321,1407,258,49,4,37,-29,86,25.74850299,3.888888889,0.305576776,2.817974105,-2.148148148,6.510219531
958,2293,760,831,840,866,866,929,873,71,9,26,0,63,-56,9.342105263,1.083032491,3.095238095,0,7.27482679,-6.027987083
959,240,1232,1212,1206,1207,1232,1200,1232,-20,-6,1,25,-32,32,-1.623376623,-0.495049505,0.08291874,2.071251036,-2.597402597,2.666666667
960,1573,978,976,976,984,1035,1068,1080,-2,0,8,51,33,12,-0.204498978,0,0.819672131,5.182926829,3.188405797,1.123595506
961,643,766,935,1087,1069,1098,1008,1097,169,152,-18,29,-90,89,22.06266319,16.25668449,-1.655933763,2.712815716,-8.196721311,8.829365079
962,2072,1235,1079,1067,1170,1147,1199,1145,-156,-12,103,-23,52,-54,-12.63157895,-1.112140871,9.653233365,-1.965811966,4.533565824,-4.503753128
963,116,1921,1875,1889,1934,2051,2149,2372,-46,14,45,117,98,223,-2.394586153,0.746666667,2.382212811,6.049638056,4.778156997,10.3769195
964,840,1118,1152,1126,1160,1183,1258,1296,34,-26,34,23,75,38,3.041144902,-2.256944444,3.019538188,1.982758621,6.339814032,3.020667727
965,188,916,888,860,833,845,876,862,-28,-28,-27,12,31,-14,-3.056768559,-3.153153153,-3.139534884,1.44057623,3.668639053,-1.598173516
966,2751,1006,972,978,974,979,1021,1043,-34,6,-4,5,42,22,-3.37972167,0.617283951,-0.408997955,0.513347023,4.290091931,2.154750245
967,1064,954,849,832,824,868,857,855,-105,-17,-8,44,-11,-2,-11.00628931,-2.002355713,-0.961538462,5.339805825,-1.267281106,-0.233372229
968,1729,1189,1026,1162,1147,1018,1003,964,-163,136,-15,-129,-15,-39,-13.70899916,13.25536062,-1.290877797,-11.2467306,-1.473477407,-3.888334995
969,1630,927,872,859,978,965,964,1012,-55,-13,119,-13,-1,48,-5.933117584,-1.490825688,13.85331781,-1.329243354,-0.103626943,4.979253112
970,1666,666,663,728,712,704,692,656,-3,65,-16,-8,-12,-36,-0.45045045,9.803921569,-2.197802198,-1.123595506,-1.704545455,-5.202312139
971,30,2158,2258,2225,2261,2308,2306,2290,100,-33,36,47,-2,-16,4.633920297,-1.461470328,1.617977528,2.078726227,-0.086655113,-0.693842151
972,815,932,929,905,923,863,904,890,-3,-24,18,-60,41,-14,-0.321888412,-2.583423036,1.988950276,-6.500541712,4.750869061,-1.548672566
973,592,1334,1418,1424,1457,1474,1369,1341,84,6,33,17,-105,-28,6.296851574,0.423131171,2.31741573,1.166781057,-7.123473541,-2.045288532
974,85,830,799,852,873,859,871,890,-31,53,21,-14,12,19,-3.734939759,6.633291615,2.464788732,-1.603665521,1.396973225,2.181400689
975,50,1684,1747,1769,1792,1822,1857,1908,63,22,23,30,35,51,3.741092637,1.25930166,1.300169587,1.674107143,1.920965971,2.746365105
976,1275,925,999,994,1026,993,1036,1038,74,-5,32,-33,43,2,8,-0.500500501,3.219315895,-3.216374269,4.330312185,0.193050193
977,1195,1527,1534,1577,1613,1732,1782,1712,7,43,36,119,50,-70,0.458415193,2.803129074,2.282815472,7.377557347,2.886836028,-3.928170595
978,944,1200,1246,1267,1249,1243,1243,1233,46,21,-18,-6,0,-10,3.833333333,1.685393258,-1.420678769,-0.480384307,0,-0.804505229
979,682,1145,1165,1026,997,1078,1183,1188,20,-139,-29,81,105,5,1.746724891,-11.93133047,-2.826510721,8.124373119,9.74025974,0.422654269
980,3089,930,923,970,1038,989,995,1099,-7,47,68,-49,6,104,-0.752688172,5.092091008,7.010309278,-4.72061657,0.606673407,10.45226131
981,2840,942,982,1015,1026,1018,1071,1059,40,33,11,-8,53,-12,4.246284501,3.360488798,1.083743842,-0.779727096,5.206286837,-1.120448179
982,1892,1206,1224,1140,1160,1206,1257,1363,18,-84,20,46,51,106,1.492537313,-6.862745098,1.754385965,3.965517241,4.228855721,8.432776452
983,1446,1130,1031,1039,1101,1146,1156,1149,-99,8,62,45,10,-7,-8.761061947,0.775945684,5.967276227,4.08719346,0.872600349,-0.605536332
984,2577,801,790,814,815,825,816,848,-11,24,1,10,-9,32,-1.373283396,3.037974684,0.122850123,1.226993865,-1.090909091,3.921568627
985,997,762,824,845,858,873,899,837,62,21,13,15,26,-62,8.13648294,2.548543689,1.538461538,1.748251748,2.978235968,-6.896551724
986,1895,1130,1142,1176,1137,1163,1113,1163,12,34,-39,26,-50,50,1.061946903,2.977232925,-3.316326531,2.286719437,-4.299226139,4.492362983
987,2436,688,717,848,863,930,949,811,29,131,15,67,19,-138,4.215116279,18.27057183,1.768867925,7.763615295,2.043010753,-14.54162276
988,97,2496,2287,2381,2427,2469,2495,2545,-209,94,46,42,26,50,-8.373397436,4.110188019,1.931961361,1.73053152,1.053057918,2.004008016
989,1693,1200,1138,1182,1187,1213,1216,1215,-62,44,5,26,3,-1,-5.166666667,3.866432337,0.423011844,2.190395956,0.247320692,-0.082236842
990,1675,963,928,953,977,1047,1052,1089,-35,25,24,70,5,37,-3.634475597,2.693965517,2.518363064,7.164790174,0.477554919,3.517110266
991,2100,1176,1123,1131,1111,1088,1135,1078,-53,8,-20,-23,47,-57,-4.506802721,0.71237756,-1.768346596,-2.070207021,4.319852941,-5.022026432
992,58,1295,1348,1372,1433,1533,1727,1861,53,24,61,100,194,134,4.092664093,1.78041543,4.44606414,6.978367062,12.65492498,7.759119861
993,1616,968,967,979,1030,1012,990,1029,-1,12,51,-18,-22,39,-0.103305785,1.240951396,5.209397344,-1.747572816,-2.173913043,3.939393939
994,1262,998,916,880,865,853,831,842,-82,-36,-15,-12,-22,11,-8.216432866,-3.930131004,-1.704545455,-1.387283237,-2.579132474,1.323706378
995,1276,928,787,693,714,773,875,969,-141,-94,21,59,102,94,-15.19396552,-11.94409149,3.03030303,8.263305322,13.19534282,10.74285714
996,1145,846,855,798,896,966,1006,942,9,-57,98,70,40,-64,1.063829787,-6.666666667,12.28070175,7.8125,4.140786749,-6.361829026
997,297,1975,2347,2219,2188,2383,2594,2633,372,-128,-31,195,211,39,18.83544304,-5.453770771,-1.397025687,8.912248629,8.854385229,1.503469545
998,388,963,957,836,877,924,914,1059,-6,-121,41,47,-10,145,-0.62305296,-12.64367816,4.90430622,5.359179019,-1.082251082,15.8643326
999,1429,1299,1272,1301,1371,1395,1443,1536,-27,29,70,24,48,93,-2.07852194,2.279874214,5.380476556,1.750547046,3.440860215,6.444906445
1000,21,2484,2442,2445,2510,2549,2766,2966,-42,3,65,39,217,200,-1.690821256,0.122850123,2.658486708,1.553784861,8.513142409,7.23065799
1001,2475,1142,1200,1101,1245,1206,1197,1200,58,-99,144,-39,-9,3,5.078809107,-8.25,13.07901907,-3.13253012,-0.746268657,0.250626566
1002,351,1178,1070,1087,1180,1118,1136,1149,-108,17,93,-62,18,13,-9.168081494,1.588785047,8.555657774,-5.254237288,1.610017889,1.144366197
1003,1544,1128,1071,1079,1006,942,1014,1196,-57,8,-73,-64,72,182,-5.053191489,0.746965453,-6.765523633,-6.361829026,7.643312102,17.94871795
1004,657,999,987,946,955,993,995,1019,-12,-41,9,38,2,24,-1.201201201,-4.154002026,0.951374207,3.979057592,0.201409869,2.412060302
1005,999,1162,1220,1235,1326,1305,1294,1311,58,15,91,-21,-11,17,4.991394148,1.229508197,7.368421053,-1.583710407,-0.842911877,1.313755796
1006,2090,676,701,763,772,731,722,698,25,62,9,-41,-9,-24,3.698224852,8.844507846,1.179554391,-5.310880829,-1.23119015,-3.324099723
1007,378,1681,1457,1594,1553,1625,1776,2002,-224,137,-41,72,151,226,-13.32540155,9.402882636,-2.572145546,4.636188023,9.292307692,12.72522523
1008,82,1356,1384,1341,1374,1423,1443,1465,28,-43,33,49,20,22,2.064896755,-3.106936416,2.460850112,3.566229985,1.405481377,1.524601525
1009,207,1100,1091,1197,1224,1225,1277,1309,-9,106,27,1,52,32,-0.818181818,9.715857012,2.255639098,0.081699346,4.244897959,2.50587314
1010,43,1592,1549,1557,1583,1616,1643,1694,-43,8,26,33,27,51,-2.701005025,0.516462234,1.66987797,2.0846494,1.670792079,3.104077906
1011,941,1344,1403,1450,1476,1497,1472,1451,59,47,26,21,-25,-21,4.389880952,3.349964362,1.793103448,1.422764228,-1.67000668,-1.426630435
1012,164,1485,1421,1436,1472,1480,1499,1543,-64,15,36,8,19,44,-4.30976431,1.055594652,2.506963788,0.543478261,1.283783784,2.935290193
1013,14,3471,3193,3317,3481,3936,4071,3955,-278,124,164,455,135,-116,-8.009219245,3.883495146,4.944226711,13.07095662,3.429878049,-2.849422746
1014,1538,985,862,827,827,856,907,897,-123,-35,0,29,51,-10,-12.48730964,-4.060324826,0,3.506650544,5.957943925,-1.102535832
1015,718,918,862,901,923,1025,997,991,-56,39,22,102,-28,-6,-6.100217865,4.524361949,2.44173141,11.05092091,-2.731707317,-0.601805416
1016,230,1229,1213,1218,1234,1253,1255,1240,-16,5,16,19,2,-15,-1.30187144,0.412201154,1.3136289,1.539708266,0.159616919,-1.195219124
1017,427,1986,1875,1861,1870,1945,1998,2122,-111,-14,9,75,53,124,-5.589123867,-0.746666667,0.483610962,4.010695187,2.724935733,6.206206206
1018,1363,972,955,967,970,975,993,1041,-17,12,3,5,18,48,-1.748971193,1.256544503,0.310237849,0.515463918,1.846153846,4.833836858
1019,1007,955,874,846,931,928,993,1041,-81,-28,85,-3,65,48,-8.481675393,-3.203661327,10.04728132,-0.322234157,7.004310345,4.833836858
1020,195,1289,1035,996,983,967,1131,995,-254,-39,-13,-16,164,-136,-19.70519783,-3.768115942,-1.305220884,-1.627670397,16.95966908,-12.02475685
1021,772,1200,1153,1195,1181,1237,1258,1275,-47,42,-14,56,21,17,-3.916666667,3.642671292,-1.171548117,4.741744285,1.697655618,1.351351351
1022,1547,942,834,860,947,921,985,1028,-108,26,87,-26,64,43,-11.46496815,3.117505995,10.11627907,-2.745512144,6.948968512,4.365482234
1023,2518,1226,1317,1193,1322,1313,1313,1241,91,-124,129,-9,0,-72,7.422512235,-9.415337889,10.81307628,-0.680786687,0,-5.483625286
1024,2286,962,986,1000,999,1015,1056,959,24,14,-1,16,41,-97,2.494802495,1.419878296,-0.1,1.601601602,4.039408867,-9.185606061
1025,180,1234,1254,1242,1269,1268,1259,1276,20,-12,27,-1,-9,17,1.620745543,-0.956937799,2.173913043,-0.078802206,-0.70977918,1.350277998
1026,64,1918,1986,2070,2195,2292,2449,2483,68,84,125,97,157,34,3.54535975,4.229607251,6.038647343,4.419134396,6.84991274,1.388321764
1027,1833,807,835,843,849,840,820,791,28,8,6,-9,-20,-29,3.469640644,0.958083832,0.711743772,-1.060070671,-2.380952381,-3.536585366
1028,152,1365,1309,1330,1368,1429,1438,1453,-56,21,38,61,9,15,-4.102564103,1.604278075,2.857142857,4.459064327,0.629811057,1.043115438
1029,1039,1379,1415,1457,1469,1435,1448,1439,36,42,12,-34,13,-9,2.610587382,2.96819788,0.823610158,-2.31449966,0.905923345,-0.621546961
1030,391,945,968,987,966,1018,986,990,23,19,-21,52,-32,4,2.433862434,1.962809917,-2.127659574,5.383022774,-3.143418468,0.405679513
1031,1951,1641,1720,1698,1744,1624,1641,1533,79,-22,46,-120,17,-108,4.814137721,-1.279069767,2.709069494,-6.880733945,1.04679803,-6.581352834
1032,2512,1102,1072,1128,1148,1137,1144,1103,-30,56,20,-11,7,-41,-2.722323049,5.223880597,1.773049645,-0.958188153,0.615655233,-3.583916084
1033,1068,695,632,731,738,732,742,728,-63,99,7,-6,10,-14,-9.064748201,15.66455696,0.957592339,-0.81300813,1.366120219,-1.886792453
1034,1208,1160,1058,1270,1388,1394,1427,1371,-102,212,118,6,33,-56,-8.793103448,20.03780718,9.291338583,0.432276657,2.367288379,-3.924316748
1035,649,1183,1114,1100,1117,1104,1155,1181,-69,-14,17,-13,51,26,-5.83262891,-1.256732496,1.545454545,-1.163831692,4.619565217,2.251082251
1036,1164,1360,1389,1423,1484,1528,1567,1645,29,34,61,44,39,78,2.132352941,2.447804176,4.286718201,2.964959569,2.552356021,4.977664327
1037,77,1595,1587,1644,1695,1704,1714,1792,-8,57,51,9,10,78,-0.501567398,3.59168242,3.102189781,0.530973451,0.58685446,4.55075846
1038,1702,1326,1326,1272,1322,1401,1482,1561,0,-54,50,79,81,79,0,-4.07239819,3.93081761,5.975794251,5.781584582,5.330634278
1039,459,957,976,919,1097,1051,989,1049,19,-57,178,-46,-62,60,1.985370951,-5.840163934,19.36887922,-4.19325433,-5.899143673,6.066734075
1040,1510,1407,1384,1411,1417,1379,1314,1262,-23,27,6,-38,-65,-52,-1.634683724,1.950867052,0.425230333,-2.681721948,-4.713560551,-3.95738204
1041,1932,1160,1111,982,1030,1036,1095,1114,-49,-129,48,6,59,19,-4.224137931,-11.61116112,4.887983707,0.582524272,5.694980695,1.735159817
1042,2171,924,965,966,1004,1014,969,930,41,1,38,10,-45,-39,4.437229437,0.103626943,3.933747412,0.996015936,-4.437869822,-4.024767802
1043,1267,1135,1171,1211,1256,1251,1274,1291,36,40,45,-5,23,17,3.171806167,3.41588386,3.715937242,-0.398089172,1.838529177,1.334379906
1044,1614,1072,1055,1063,1131,1128,1161,1241,-17,8,68,-3,33,80,-1.585820896,0.758293839,6.396989652,-0.265251989,2.925531915,6.890611542
1045,60,986,910,921,1030,1073,1075,1045,-76,11,109,43,2,-30,-7.707910751,1.208791209,11.834962,4.174757282,0.18639329,-2.790697674
1046,527,1634,1522,1352,1502,1739,1608,1680,-112,-170,150,237,-131,72,-6.854345165,-11.1695138,11.09467456,15.77896138,-7.53306498,4.47761194
1047,287,1158,1106,1177,1243,1257,1393,1378,-52,71,66,14,136,-15,-4.490500864,6.419529837,5.607476636,1.126307321,10.8194113,-1.076812635
1048,1655,1005,1199,1228,1181,1124,1118,1135,194,29,-47,-57,-6,17,19.30348259,2.418682235,-3.827361564,-4.82641829,-0.533807829,1.520572451
1049,102,1357,1201,1211,1294,1286,1335,1420,-156,10,83,-8,49,85,-11.49594694,0.832639467,6.853839802,-0.618238022,3.810264386,6.367041199
1050,1271,1001,978,956,951,933,915,892,-23,-22,-5,-18,-18,-23,-2.297702298,-2.249488753,-0.523012552,-1.892744479,-1.92926045,-2.513661202
1051,4,2404,2484,2499,2569,2704,2796,2947,80,15,70,135,92,151,3.327787022,0.603864734,2.801120448,5.254963021,3.402366864,5.400572246
1052,1165,1182,1199,1223,1270,1312,1373,1437,17,24,47,42,61,64,1.438240271,2.001668057,3.843008994,3.307086614,4.649390244,4.661325564
1053,1315,1417,1322,1411,1428,1489,1630,1529,-95,89,17,61,141,-101,-6.704304869,6.732223903,1.204819277,4.271708683,9.469442579,-6.196319018
1054,128,1599,1731,1726,1698,1793,1794,1844,132,-5,-28,95,1,50,8.255159475,-0.288850376,-1.622247972,5.594817432,0.055772448,2.787068004
1055,1400,1171,1130,1103,1171,1197,1210,1110,-41,-27,68,26,13,-100,-3.501280956,-2.389380531,6.165004533,2.220324509,1.086048454,-8.26446281
1056,758,1196,1220,1249,1244,1227,1233,1317,24,29,-5,-17,6,84,2.006688963,2.37704918,-0.400320256,-1.366559486,0.488997555,6.812652068
1057,399,858,937,961,998,894,948,923,79,24,37,-104,54,-25,9.207459207,2.561366062,3.850156087,-10.42084168,6.040268456,-2.637130802
1058,661,1285,1309,1333,1278,1367,1295,1277,24,24,-55,89,-72,-18,1.86770428,1.833460657,-4.126031508,6.96400626,-5.267008047,-1.38996139
1059,2092,756,815,857,855,853,827,862,59,42,-2,-2,-26,35,7.804232804,5.153374233,-0.233372229,-0.233918129,-3.048065651,4.23216445
1060,613,895,874,867,905,942,1028,968,-21,-7,38,37,86,-60,-2.346368715,-0.800915332,4.382929642,4.08839779,9.129511677,-5.836575875
1061,1231,1036,1087,1117,1193,1237,1288,1322,51,30,76,44,51,34,4.922779923,2.759889604,6.803939123,3.688181056,4.12287793,2.639751553
1062,1820,1000,858,940,842,843,896,848,-142,82,-98,1,53,-48,-14.2,9.557109557,-10.42553191,0.118764846,6.287069988,-5.357142857
1063,324,1311,1343,1406,1360,1429,1297,1274,32,63,-46,69,-132,-23,2.440884821,4.69099032,-3.271692745,5.073529412,-9.237228831,-1.773323053
1064,1468,921,1075,1011,966,940,906,858,154,-64,-45,-26,-34,-48,16.72095548,-5.953488372,-4.451038576,-2.691511387,-3.617021277,-5.298013245
1065,985,975,1004,1013,1125,1078,1124,1146,29,9,112,-47,46,22,2.974358974,0.896414343,11.05626851,-4.177777778,4.26716141,1.957295374
1066,1812,1108,865,843,885,880,939,909,-243,-22,42,-5,59,-30,-21.93140794,-2.543352601,4.982206406,-0.564971751,6.704545455,-3.194888179
1067,513,1355,1435,1475,1456,1064,1355,1332,80,40,-19,-392,291,-23,5.904059041,2.787456446,-1.288135593,-26.92307692,27.34962406,-1.697416974
1068,681,1144,1075,1058,1101,1171,1198,1195,-69,-17,43,70,27,-3,-6.031468531,-1.581395349,4.064272212,6.357856494,2.305721605,-0.250417362
1069,1491,1228,1179,1246,1252,1257,1267,1231,-49,67,6,5,10,-36,-3.990228013,5.682782019,0.481540931,0.399361022,0.795544948,-2.841357537
1070,1139,1650,2012,1792,1439,1610,1835,1804,362,-220,-353,171,225,-31,21.93939394,-10.93439364,-19.69866071,11.88325226,13.97515528,-1.689373297
1071,1063,929,870,898,1010,986,1016,1001,-59,28,112,-24,30,-15,-6.350914962,3.218390805,12.47216036,-2.376237624,3.042596349,-1.476377953
1072,908,1085,1039,1057,1066,1123,1086,1219,-46,18,9,57,-37,133,-4.239631336,1.732435034,0.851466414,5.347091932,-3.294746215,12.24677716
1073,1815,1125,1164,1195,1168,1202,1200,1178,39,31,-27,34,-2,-22,3.466666667,2.663230241,-2.259414226,2.910958904,-0.166389351,-1.833333333
1074,1162,1614,1558,1570,1662,1784,1812,1936,-56,12,92,122,28,124,-3.469640644,0.770218228,5.859872611,7.34055355,1.569506726,6.843267108
1075,1948,1173,1100,1107,1115,1006,1073,1053,-73,7,8,-109,67,-20,-6.223358909,0.636363636,0.722673893,-9.775784753,6.660039761,-1.863932898
1076,975,1200,1174,1202,1237,1301,1407,1518,-26,28,35,64,106,111,-2.166666667,2.385008518,2.911813644,5.173807599,8.147578786,7.8891258
1077,330,1246,1356,1394,1458,1419,1501,1544,110,38,64,-39,82,43,8.828250401,2.802359882,4.591104735,-2.674897119,5.778717407,2.864756829
1078,1194,1152,1105,1107,1195,1193,1235,1279,-47,2,88,-2,42,44,-4.079861111,0.180995475,7.949412827,-0.167364017,3.520536463,3.562753036
1079,689,1043,1082,1070,1058,1039,1037,1036,39,-12,-12,-19,-2,-1,3.739213806,-1.109057301,-1.121495327,-1.79584121,-0.192492782,-0.096432015
1080,93,1863,1652,1544,1679,1784,1827,1817,-211,-108,135,105,43,-10,-11.32581857,-6.537530266,8.743523316,6.253722454,2.410313901,-0.547345375
1081,940,1150,1167,1152,1096,1058,1117,1013,17,-15,-56,-38,59,-104,1.47826087,-1.285347044,-4.861111111,-3.467153285,5.576559546,-9.310653536
1082,1300,1018,1030,1004,1016,1075,1116,1198,12,-26,12,59,41,82,1.178781925,-2.524271845,1.195219124,5.807086614,3.813953488,7.347670251
1083,2423,644,666,820,803,899,853,721,22,154,-17,96,-46,-132,3.416149068,23.12312312,-2.073170732,11.95516812,-5.11679644,-15.47479484
1084,446,1100,1011,1107,1150,1044,1082,1131,-89,96,43,-106,38,49,-8.090909091,9.495548961,3.884372177,-9.217391304,3.639846743,4.528650647
1085,1760,991,994,1007,1004,1042,1050,1071,3,13,-3,38,8,21,0.302724521,1.307847082,-0.297914598,3.784860558,0.767754319,2
1086,1496,1018,1157,981,1068,1076,1141,1136,139,-176,87,8,65,-5,13.65422397,-15.21175454,8.868501529,0.74906367,6.040892193,-0.438212095
1087,2284,1022,1014,1020,1071,1090,1156,1087,-8,6,51,19,66,-69,-0.782778865,0.591715976,5,1.774042951,6.055045872,-5.968858131
1088,1033,1193,1181,1170,1208,1227,1224,1235,-12,-11,38,19,-3,11,-1.005867561,-0.931414056,3.247863248,1.572847682,-0.244498778,0.89869281
1089,576,1193,1274,1258,1283,1287,1362,1328,81,-16,25,4,75,-34,6.789606035,-1.25588697,1.987281399,0.311769291,5.827505828,-2.496328928
1090,1265,1202,1168,939,966,950,912,925,-34,-229,27,-16,-38,13,-2.828618968,-19.60616438,2.875399361,-1.6563147,-4,1.425438596
1091,2415,748,951,1007,1014,1061,1003,1079,203,56,7,47,-58,76,27.13903743,5.888538381,0.695134062,4.635108481,-5.466540999,7.577268195
1092,1944,1094,1098,1112,1129,1123,1088,1099,4,14,17,-6,-35,11,0.365630713,1.275045537,1.528776978,-0.531443756,-3.116651825,1.011029412
1093,2073,802,804,763,796,818,828,835,2,-41,33,22,10,7,0.249376559,-5.099502488,4.325032765,2.763819095,1.222493888,0.845410628
1094,2036,793,848,831,803,810,799,850,55,-17,-28,7,-11,51,6.935687264,-2.004716981,-3.369434416,0.871731009,-1.358024691,6.382978723
1095,1876,699,802,814,810,794,860,838,103,12,-4,-16,66,-22,14.73533619,1.496259352,-0.491400491,-1.975308642,8.312342569,-2.558139535
1096,737,781,846,854,888,890,916,897,65,8,34,2,26,-19,8.322663252,0.945626478,3.981264637,0.225225225,2.921348315,-2.074235808
1097,629,1200,1188,1178,1183,1213,1198,1199,-12,-10,5,30,-15,1,-1,-0.841750842,0.424448217,2.535925613,-1.236603462,0.083472454
1098,2403,750,768,767,738,825,788,762,18,-1,-29,87,-37,-26,2.4,-0.130208333,-3.780964798,11.78861789,-4.484848485,-3.299492386
1099,2472,1028,952,913,950,934,943,1040,-76,-39,37,-16,9,97,-7.392996109,-4.096638655,4.052573932,-1.684210526,0.96359743,10.28632025
1100,1618,948,950,975,1031,1029,1042,1063,2,25,56,-2,13,21,0.210970464,2.631578947,5.743589744,-0.193986421,1.263362488,2.015355086
1101,776,941,901,908,897,874,894,895,-40,7,-11,-23,20,1,-4.250797024,0.776914539,-1.211453744,-2.564102564,2.288329519,0.111856823
1102,1566,937,884,830,690,734,742,743,-53,-54,-140,44,8,1,-5.656350053,-6.108597285,-16.86746988,6.376811594,1.089918256,0.134770889
1103,15,1092,1080,1083,1077,1170,1185,1204,-12,3,-6,93,15,19,-1.098901099,0.277777778,-0.55401662,8.635097493,1.282051282,1.603375527
1104,551,1120,1110,1112,1184,1172,1218,1259,-10,2,72,-12,46,41,-0.892857143,0.18018018,6.474820144,-1.013513514,3.924914676,3.366174056
1105,1735,1064,1028,998,1097,1145,1165,1209,-36,-30,99,48,20,44,-3.383458647,-2.918287938,9.919839679,4.375569736,1.746724891,3.776824034
1106,326,947,840,907,1020,997,1023,1101,-107,67,113,-23,26,78,-11.29883844,7.976190476,12.45865491,-2.254901961,2.60782347,7.624633431
1107,52,1407,1382,1384,1490,1473,1543,1645,-25,2,106,-17,70,102,-1.776830135,0.1447178,7.658959538,-1.140939597,4.752206382,6.610499028
1108,686,1007,1172,1203,1230,1200,1182,1241,165,31,27,-30,-18,59,16.38530288,2.645051195,2.244389027,-2.43902439,-1.5,4.991539763
1109,770,940,913,910,913,936,950,1000,-27,-3,3,23,14,50,-2.872340426,-0.328587076,0.32967033,2.519167579,1.495726496,5.263157895
1110,1891,1116,1052,1019,1068,1074,1082,1126,-64,-33,49,6,8,44,-5.734767025,-3.136882129,4.808635918,0.561797753,0.744878957,4.066543438
1111,1609,942,975,870,949,974,909,915,33,-105,79,25,-65,6,3.503184713,-10.76923077,9.08045977,2.634351949,-6.673511294,0.660066007
1112,1489,1266,1193,1153,1213,1276,1251,1271,-73,-40,60,63,-25,20,-5.766192733,-3.352891869,5.203816132,5.193734542,-1.959247649,1.598721023
1113,29,1079,1079,1095,1093,1093,1095,1138,0,16,-2,0,2,43,0,1.482854495,-0.182648402,0,0.182982617,3.926940639
1114,126,913,914,917,921,949,993,1086,1,3,4,28,44,93,0.109529025,0.328227571,0.436205016,3.040173724,4.636459431,9.365558912
1115,1170,1165,1147,1160,1216,1272,1340,1412,-18,13,56,56,68,72,-1.545064378,1.133391456,4.827586207,4.605263158,5.34591195,5.373134328
1116,242,889,925,941,937,957,1018,1017,36,16,-4,20,61,-1,4.049493813,1.72972973,-0.425079702,2.134471718,6.374085684,-0.098231827
1117,633,731,801,769,836,778,889,870,70,-32,67,-58,111,-19,9.575923393,-3.995006242,8.712613784,-6.937799043,14.26735219,-2.137232846
1118,137,1729,1744,1778,1825,1842,1946,2087,15,34,47,17,104,141,0.867553499,1.949541284,2.643419573,0.931506849,5.646036916,7.245632066
1119,1383,1183,1303,1148,1225,1258,1407,1429,120,-155,77,33,149,22,10.14370245,-11.89562548,6.707317073,2.693877551,11.84419714,1.563610519
1120,926,1494,1428,1415,1329,1343,1362,1418,-66,-13,-86,14,19,56,-4.417670683,-0.910364146,-6.077738516,1.053423627,1.414743112,4.111600587
1121,96,1478,1597,1671,1674,1691,1973,1990,119,74,3,17,282,17,8.051420839,4.633688165,0.179533214,1.015531661,16.67652277,0.861632032
1122,915,766,794,852,857,838,841,851,28,58,5,-19,3,10,3.65535248,7.304785894,0.58685446,-2.217036173,0.357995227,1.189060642
1123,1185,970,977,1002,1089,1109,1155,1199,7,25,87,20,46,44,0.721649485,2.558853634,8.682634731,1.836547291,4.147880974,3.80952381
1124,1602,936,912,920,911,915,895,928,-24,8,-9,4,-20,33,-2.564102564,0.877192982,-0.97826087,0.439077936,-2.18579235,3.687150838
1125,112,1200,1182,1173,1193,1243,1284,1292,-18,-9,20,50,41,8,-1.5,-0.76142132,1.705029838,4.191114837,3.29847144,0.62305296
1126,2161,1160,1095,1114,1136,1213,1187,1204,-65,19,22,77,-26,17,-5.603448276,1.735159817,1.97486535,6.778169014,-2.143446002,1.432181971
1127,1722,729,802,794,785,854,883,854,73,-8,-9,69,29,-29,10.01371742,-0.997506234,-1.133501259,8.789808917,3.395784543,-3.284258211
1128,1858,1215,1149,1163,1156,1196,1256,1244,-66,14,-7,40,60,-12,-5.432098765,1.218450827,-0.60189166,3.460207612,5.016722408,-0.955414013
1129,454,1032,1159,1188,1194,1328,1438,1543,127,29,6,134,110,105,12.30620155,2.502157032,0.505050505,11.22278057,8.28313253,7.301808067
1130,646,1031,1178,1187,1167,1106,1078,1141,147,9,-20,-61,-28,63,14.25800194,0.764006791,-1.684919966,-5.227077978,-2.53164557,5.844155844
1131,719,712,758,786,838,801,883,872,46,28,52,-37,82,-11,6.460674157,3.693931398,6.615776081,-4.415274463,10.2372035,-1.245753114
1132,517,799,813,859,881,879,880,893,14,46,22,-2,1,13,1.752190238,5.658056581,2.561117579,-0.227014756,0.113765643,1.477272727
1133,1953,1639,1704,1686,1694,1680,1697,1731,65,-18,8,-14,17,34,3.965832825,-1.056338028,0.474495848,-0.826446281,1.011904762,2.003535651
1134,255,1145,1093,931,1138,1100,1112,1206,-52,-162,207,-38,12,94,-4.541484716,-14.82159195,22.23415682,-3.339191564,1.090909091,8.45323741
1135,250,1335,1283,1250,1515,1527,1499,1504,-52,-33,265,12,-28,5,-3.895131086,-2.572096648,21.2,0.792079208,-1.833660773,0.333555704
1136,389,1131,1174,1139,1180,1190,1202,1185,43,-35,41,10,12,-17,3.801945181,-2.981260647,3.599648815,0.847457627,1.008403361,-1.414309484
1137,1784,1032,954,898,1015,1031,1018,1043,-78,-56,117,16,-13,25,-7.558139535,-5.870020964,13.02895323,1.57635468,-1.260911736,2.455795678
1138,1844,974,1188,1212,1223,1238,1237,1213,214,24,11,15,-1,-24,21.97125257,2.02020202,0.907590759,1.226492232,-0.080775444,-1.94017785
1139,475,675,721,759,821,858,860,808,46,38,62,37,2,-52,6.814814815,5.270457698,8.168642951,4.506699147,0.233100233,-6.046511628
1140,395,1037,912,938,892,1007,940,1070,-125,26,-46,115,-67,130,-12.05400193,2.850877193,-4.904051173,12.89237668,-6.653426018,13.82978723
1141,955,1098,1102,1095,1072,1085,1006,976,4,-7,-23,13,-79,-30,0.364298725,-0.635208711,-2.100456621,1.212686567,-7.281105991,-2.982107356
1142,1330,918,931,722,814,847,893,894,13,-209,92,33,46,1,1.416122004,-22.44897959,12.74238227,4.054054054,5.430932704,0.111982083
1143,2115,797,792,785,819,813,795,840,-5,-7,34,-6,-18,45,-0.627352572,-0.883838384,4.331210191,-0.732600733,-2.21402214,5.660377358
1144,935,999,928,1029,1064,1124,1150,1065,-71,101,35,60,26,-85,-7.107107107,10.88362069,3.401360544,5.639097744,2.31316726,-7.391304348
1145,1756,1343,1417,1440,1491,1506,1500,1519,74,23,51,15,-6,19,5.510052122,1.623147495,3.541666667,1.006036217,-0.398406375,1.266666667
1146,2003,657,882,869,816,826,767,749,225,-13,-53,10,-59,-18,34.24657534,-1.473922902,-6.098964327,1.225490196,-7.142857143,-2.346805737
1147,2202,814,757,810,872,877,870,888,-57,53,62,5,-7,18,-7.002457002,7.001321004,7.654320988,0.573394495,-0.798175599,2.068965517
1148,869,1219,1258,1203,1228,1205,1216,1182,39,-55,25,-23,11,-34,3.199343724,-4.372019078,2.078137988,-1.872964169,0.912863071,-2.796052632
1149,1657,1274,1311,1301,1314,1328,1302,1335,37,-10,13,14,-26,33,2.904238619,-0.762776506,0.99923136,1.065449011,-1.957831325,2.534562212
1150,42,1798,1789,1779,1804,1844,1847,1929,-9,-10,25,40,3,82,-0.500556174,-0.558971492,1.405283867,2.2172949,0.162689805,4.439631835
1151,120,1818,1857,1926,1930,1919,1969,1968,39,69,4,-11,50,-1,2.145214521,3.715670436,0.20768432,-0.569948187,2.60552371,-0.050787202
1152,70,1427,1303,1365,1380,1478,1497,1612,-124,62,15,98,19,115,-8.689558514,4.758250192,1.098901099,7.101449275,1.285520974,7.682030728
1153,2642,955,840,941,920,886,942,988,-115,101,-21,-34,56,46,-12.04188482,12.02380952,-2.231668438,-3.695652174,6.320541761,4.883227176
1154,263,990,935,1081,968,928,1020,1117,-55,146,-113,-40,92,97,-5.555555556,15.61497326,-10.453284,-4.132231405,9.913793103,9.509803922
1155,124,828,952,951,997,987,996,999,124,-1,46,-10,9,3,14.97584541,-0.105042017,4.83701367,-1.003009027,0.911854103,0.301204819
1156,2120,936,923,929,912,905,923,899,-13,6,-17,-7,18,-24,-1.388888889,0.650054171,-1.82992465,-0.76754386,1.988950276,-2.600216685
1157,1519,976,923,1091,1071,1028,1030,984,-53,168,-20,-43,2,-46,-5.430327869,18.20151679,-1.833180568,-4.014939309,0.194552529,-4.466019417
1158,1426,953,746,753,826,836,1049,1007,-207,7,73,10,213,-42,-21.72088143,0.938337802,9.694555113,1.210653753,25.4784689,-4.003813155
1159,1852,1243,1270,1159,1179,1218,1258,1295,27,-111,20,39,40,37,2.172164119,-8.74015748,1.725625539,3.307888041,3.28407225,2.941176471
1160,2552,1262,1295,1320,1239,1214,1223,1162,33,25,-81,-25,9,-61,2.614896989,1.930501931,-6.136363636,-2.017756255,0.741350906,-4.987735078
1161,373,2094,1993,2073,2103,2064,2320,2343,-101,80,30,-39,256,23,-4.82330468,4.014049172,1.447178003,-1.854493581,12.40310078,0.99137931
1162,1432,971,991,658,833,897,990,1050,20,-333,175,64,93,60,2.059732235,-33.6024218,26.59574468,7.683073229,10.36789298,6.060606061
1163,1500,1197,1304,1254,1228,1064,1099,1108,107,-50,-26,-164,35,9,8.939014202,-3.834355828,-2.073365231,-13.35504886,3.289473684,0.818926297
1164,610,1638,1682,1756,1741,1893,1779,1796,44,74,-15,152,-114,17,2.686202686,4.399524376,-0.854214123,8.730614589,-6.022187005,0.95559303
1165,7,1695,1685,1773,1963,2114,2254,2283,-10,88,190,151,140,29,-0.589970501,5.222551929,10.71630006,7.692307692,6.622516556,1.286601597
1166,2633,907,884,866,868,865,848,869,-23,-18,2,-3,-17,21,-2.535832415,-2.036199095,0.230946882,-0.34562212,-1.965317919,2.476415094
1167,1916,1212,1197,1122,1171,1145,1163,1208,-15,-75,49,-26,18,45,-1.237623762,-6.26566416,4.367201426,-2.220324509,1.572052402,3.869303525
1168,1961,1198,1111,1088,1192,1165,1265,1233,-87,-23,104,-27,100,-32,-7.262103506,-2.070207021,9.558823529,-2.265100671,8.583690987,-2.529644269
1169,1408,924,867,1109,949,901,875,816,-57,242,-160,-48,-26,-59,-6.168831169,27.91234141,-14.42741208,-5.057955743,-2.885682575,-6.742857143
1170,92,1059,1303,1312,1393,1400,1443,1477,244,9,81,7,43,34,23.04060434,0.690713738,6.173780488,0.502512563,3.071428571,2.356202356
1171,1332,1224,1237,1213,1332,1366,1414,1388,13,-24,119,34,48,-26,1.062091503,-1.94017785,9.810387469,2.552552553,3.513909224,-1.838755304
1172,1688,1238,1106,1172,1149,1087,1120,1087,-132,66,-23,-62,33,-33,-10.66235864,5.967450271,-1.962457338,-5.395996519,3.035878565,-2.946428571
1173,2047,783,714,712,746,765,752,735,-69,-2,34,19,-13,-17,-8.812260536,-0.280112045,4.775280899,2.54691689,-1.699346405,-2.260638298
1174,1796,836,833,791,807,836,827,826,-3,-42,16,29,-9,-1,-0.358851675,-5.042016807,2.022756005,3.593556382,-1.076555024,-0.120918984
1175,1301,877,881,866,841,889,837,942,4,-15,-25,48,-52,105,0.456100342,-1.70261067,-2.886836028,5.707491082,-5.849268841,12.54480287
1176,1302,1096,1024,1090,1239,1319,1301,1343,-72,66,149,80,-18,42,-6.569343066,6.4453125,13.66972477,6.456820016,-1.364670205,3.228285934
1177,1318,1100,1153,977,876,1046,1088,1077,53,-176,-101,170,42,-11,4.818181818,-15.26452732,-10.33776868,19.40639269,4.015296367,-1.011029412
1178,1106,1226,1331,1381,1374,1465,1499,1445,105,50,-7,91,34,-54,8.564437194,3.756574005,-0.506879073,6.622998544,2.320819113,-3.602401601
1179,2994,1055,1063,1017,1153,1208,1175,1244,8,-46,136,55,-33,69,0.758293839,-4.327375353,13.3726647,4.770164788,-2.731788079,5.872340426
1180,1057,797,893,925,1023,1001,1001,1005,96,32,98,-22,0,4,12.04516939,3.583426652,10.59459459,-2.150537634,0,0.3996004
1181,2279,1150,1102,1035,1084,1145,1128,1086,-48,-67,49,61,-17,-42,-4.173913043,-6.079854809,4.734299517,5.627306273,-1.484716157,-3.723404255
1182,2854,967,974,985,973,1014,1044,962,7,11,-12,41,30,-82,0.723888314,1.12936345,-1.218274112,4.21377184,2.958579882,-7.85440613
1183,2416,1050,1028,1047,1129,1160,1202,1196,-22,19,82,31,42,-6,-2.095238095,1.848249027,7.831900669,2.745792737,3.620689655,-0.499168053
1184,1464,680,753,829,812,798,749,747,73,76,-17,-14,-49,-2,10.73529412,10.09296149,-2.05066345,-1.724137931,-6.140350877,-0.267022697
1185,262,1551,1261,1388,1377,1342,1284,1338,-290,127,-11,-35,-58,54,-18.69761444,10.07137193,-0.792507205,-2.541757444,-4.321907601,4.205607477
1186,2282,1149,1116,1062,1093,1162,1145,1102,-33,-54,31,69,-17,-43,-2.872062663,-4.838709677,2.919020716,6.312900274,-1.462994836,-3.755458515
1187,501,1231,1179,1193,1137,1240,1255,1344,-52,14,-56,103,15,89,-4.224207961,1.187446989,-4.694048617,9.058927001,1.209677419,7.091633466
1188,317,800,846,856,759,728,723,743,46,10,-97,-31,-5,20,5.75,1.182033097,-11.3317757,-4.084321476,-0.686813187,2.766251729
1189,123,1063,1047,1098,1101,1126,1156,1148,-16,51,3,25,30,-8,-1.505174036,4.871060172,0.273224044,2.270663034,2.664298401,-0.692041522
1190,204,897,1006,1043,1107,1106,1163,1216,109,37,64,-1,57,53,12.1516165,3.677932406,6.136145733,-0.090334237,5.153707052,4.557179708
1191,1254,892,761,755,786,795,813,846,-131,-6,31,9,18,33,-14.68609865,-0.788436268,4.105960265,1.145038168,2.264150943,4.05904059
1192,1553,788,824,853,841,799,796,793,36,29,-12,-42,-3,-3,4.568527919,3.519417476,-1.406799531,-4.994054697,-0.375469337,-0.376884422
1193,101,1956,1832,1890,2034,2182,2126,2213,-124,58,144,148,-56,87,-6.339468303,3.165938865,7.619047619,7.276302852,-2.566452796,4.09219191
1194,1084,1168,1186,1220,1216,1233,1222,1211,18,34,-4,17,-11,-11,1.54109589,2.866779089,-0.327868852,1.398026316,-0.892133009,-0.900163666
1195,1435,1050,1211,1255,1289,1274,1276,1263,161,44,34,-15,2,-13,15.33333333,3.633360859,2.709163347,-1.163692785,0.156985871,-1.018808777
1196,1982,1172,1238,1299,1200,1106,1150,1155,66,61,-99,-94,44,5,5.631399317,4.9273021,-7.621247113,-7.833333333,3.978300181,0.434782609
1197,1118,1290,1228,1324,1288,1350,1608,1406,-62,96,-36,62,258,-202,-4.80620155,7.817589577,-2.719033233,4.813664596,19.11111111,-12.56218905
1198,1954,1038,1038,1070,1118,1047,1045,1139,0,32,48,-71,-2,94,0,3.082851638,4.485981308,-6.350626118,-0.191021968,8.995215311
1199,1738,993,957,942,1006,1003,980,1013,-36,-15,64,-3,-23,33,-3.625377644,-1.567398119,6.794055202,-0.298210736,-2.293120638,3.367346939
1200,8,1692,1643,1634,1686,1744,1788,1851,-49,-9,52,58,44,63,-2.895981087,-0.547778454,3.182374541,3.440094899,2.52293578,3.523489933
1201,1506,990,995,1003,1032,1007,949,1019,5,8,29,-25,-58,70,0.505050505,0.804020101,2.891326022,-2.42248062,-5.759682224,7.376185458
1202,384,957,851,881,887,847,969,879,-106,30,6,-40,122,-90,-11.07628004,3.525264395,0.681044268,-4.509582864,14.40377804,-9.287925697
1203,400,1148,1161,1147,1137,1162,1114,1173,13,-14,-10,25,-48,59,1.132404181,-1.20585702,-0.871839582,2.19876869,-4.13080895,5.296229803
1204,490,956,988,994,1042,1079,1137,1202,32,6,48,37,58,65,3.347280335,0.607287449,4.828973843,3.550863724,5.375347544,5.716798593
1205,301,795,785,799,765,802,798,795,-10,14,-34,37,-4,-3,-1.257861635,1.78343949,-4.255319149,4.836601307,-0.498753117,-0.37593985
1206,1295,1222,1077,827,924,888,826,820,-145,-250,97,-36,-62,-6,-11.86579378,-23.21262767,11.72914148,-3.896103896,-6.981981982,-0.726392252
1207,2537,1053,1077,1068,1101,1149,1161,1132,24,-9,33,48,12,-29,2.279202279,-0.835654596,3.08988764,4.359673025,1.044386423,-2.497846684
1208,889,1176,1162,1162,1192,1215,1229,1248,-14,0,30,23,14,19,-1.19047619,0,2.581755594,1.929530201,1.152263374,1.545972335
1209,1391,1090,1054,983,990,1119,1081,1085,-36,-71,7,129,-38,4,-3.302752294,-6.736242884,0.712105799,13.03030303,-3.395889187,0.370027752
1210,1376,838,841,819,650,840,841,846,3,-22,-169,190,1,5,0.357995227,-2.615933413,-20.63492063,29.23076923,0.119047619,0.594530321
1211,1220,1780,1755,1753,1763,1780,1875,1889,-25,-2,10,17,95,14,-1.404494382,-0.113960114,0.570450656,0.964265457,5.337078652,0.746666667
1212,450,1165,1207,1074,1145,1007,1092,1137,42,-133,71,-138,85,45,3.605150215,-11.01905551,6.610800745,-12.05240175,8.440913605,4.120879121
1213,147,2448,2369,2460,2469,2487,2682,2753,-79,91,9,18,195,71,-3.227124183,3.841283242,0.365853659,0.729040097,7.840772014,2.647278151
1214,438,1518,1575,1638,1687,1773,1823,1882,57,63,49,86,50,59,3.754940711,4,2.991452991,5.097806758,2.820078962,3.236423478
1215,416,895,887,911,920,941,978,983,-8,24,9,21,37,5,-0.893854749,2.705749718,0.987925357,2.282608696,3.931987248,0.511247444
1216,442,828,876,893,917,920,992,1009,48,17,24,3,72,17,5.797101449,1.940639269,2.687569989,0.327153762,7.826086957,1.713709677
1217,868,1896,1587,1533,1642,1855,1980,2136,-309,-54,109,213,125,156,-16.29746835,-3.402646503,7.110241357,12.97198538,6.738544474,7.878787879
1218,291,916,862,829,888,912,959,971,-54,-33,59,24,47,12,-5.895196507,-3.828306265,7.117008444,2.702702703,5.153508772,1.251303441
1219,1897,913,791,769,862,852,825,907,-122,-22,93,-10,-27,82,-13.36254107,-2.781289507,12.09362809,-1.160092807,-3.169014085,9.939393939
1220,2996,649,663,848,797,882,850,697,14,185,-51,85,-32,-153,2.157164869,27.90346908,-6.014150943,10.66499373,-3.628117914,-18
1221,1511,1209,1199,1174,1244,1251,1256,1238,-10,-25,70,7,5,-18,-0.827129859,-2.085070892,5.962521295,0.562700965,0.399680256,-1.433121019
1222,569,799,869,949,934,923,885,851,70,80,-15,-11,-38,-34,8.760951189,9.20598389,-1.58061117,-1.177730193,-4.117009751,-3.84180791
1223,481,863,876,861,869,857,846,902,13,-15,8,-12,-11,56,1.506373117,-1.712328767,0.929152149,-1.380897583,-1.283547258,6.619385343
1224,168,1094,1051,1102,1180,1242,1263,1362,-43,51,78,62,21,99,-3.930530165,4.852521408,7.078039927,5.254237288,1.690821256,7.83847981
1225,1071,929,854,868,821,876,949,891,-75,14,-47,55,73,-58,-8.073196986,1.639344262,-5.414746544,6.699147381,8.333333333,-6.111696523
1226,19,1354,1354,1370,1392,1446,1513,1619,0,16,22,54,67,106,0,1.1816839,1.605839416,3.879310345,4.633471646,7.005948447
1227,1255,957,722,686,696,707,724,773,-235,-36,10,11,17,49,-24.55590387,-4.986149584,1.457725948,1.58045977,2.404526167,6.767955801
1228,132,1257,1346,1367,1428,1472,1495,1507,89,21,61,44,23,12,7.08035004,1.560178306,4.462326262,3.081232493,1.5625,0.802675585
1229,424,997,978,1035,1161,1155,1140,1212,-19,57,126,-6,-15,72,-1.905717151,5.828220859,12.17391304,-0.516795866,-1.298701299,6.315789474
1230,1229,1230,930,987,913,938,890,918,-300,57,-74,25,-48,28,-24.3902439,6.129032258,-7.497467072,2.73822563,-5.117270789,3.146067416
1231,1280,1089,909,846,1097,995,961,1131,-180,-63,251,-102,-34,170,-16.52892562,-6.930693069,29.66903073,-9.298085688,-3.417085427,17.68990635
1232,422,1046,1376,1292,1336,1320,1455,1543,330,-84,44,-16,135,88,31.54875717,-6.104651163,3.405572755,-1.19760479,10.22727273,6.048109966
1233,1261,1626,1556,1578,1716,1733,1791,1831,-70,22,138,17,58,40,-4.30504305,1.413881748,8.745247148,0.990675991,3.346797461,2.233389168
1234,1233,951,902,801,793,803,816,939,-49,-101,-8,10,13,123,-5.152471083,-11.19733925,-0.998751561,1.261034048,1.618929016,15.07352941
1235,1477,1098,917,896,909,961,986,981,-181,-21,13,52,25,-5,-16.4845173,-2.290076336,1.450892857,5.720572057,2.601456816,-0.507099391
1236,1394,1016,1151,1093,1139,1144,1140,1100,135,-58,46,5,-4,-40,13.28740157,-5.039096438,4.208600183,0.438981563,-0.34965035,-3.50877193
1237,344,1306,1337,1389,1341,1293,1259,1237,31,52,-48,-48,-34,-22,2.373660031,3.889304413,-3.455723542,-3.579418345,-2.629543697,-1.747418586
1238,143,846,889,859,831,880,901,957,43,-30,-28,49,21,56,5.082742317,-3.374578178,-3.259604191,5.896510229,2.386363636,6.215316315
1239,28,1179,1163,1166,1178,1207,1222,1238,-16,3,12,29,15,16,-1.357082273,0.257953568,1.02915952,2.46179966,1.242750621,1.309328969
1240,1225,1050,1107,1157,1193,1272,1345,1399,57,50,36,79,73,54,5.428571429,4.516711834,3.111495246,6.621961442,5.738993711,4.014869888
1241,1522,1211,1260,1185,1101,1190,1214,1174,49,-75,-84,89,24,-40,4.046242775,-5.952380952,-7.088607595,8.0835604,2.016806723,-3.294892916
1242,2009,1178,1237,1325,1241,1373,1325,1108,59,88,-84,132,-48,-217,5.008488964,7.113985449,-6.339622642,10.6365834,-3.495994173,-16.37735849
1243,357,1422,1491,1631,1582,1533,1546,1590,69,140,-49,-49,13,44,4.852320675,9.389671362,-3.004291845,-3.097345133,0.848010437,2.846054334
1244,848,1091,1093,1080,1138,1035,1156,1154,2,-13,58,-103,121,-2,0.183318057,-1.189387008,5.37037037,-9.050966608,11.69082126,-0.173010381
1245,492,1448,1298,1321,1235,1255,1301,1364,-150,23,-86,20,46,63,-10.35911602,1.771956857,-6.510219531,1.619433198,3.665338645,4.842428901
1246,353,887,1048,1008,1193,1146,1168,1139,161,-40,185,-47,22,-29,18.15107103,-3.816793893,18.3531746,-3.939647946,1.919720768,-2.482876712
1247,1499,769,902,1025,830,876,801,841,133,123,-195,46,-75,40,17.29518856,13.63636364,-19.02439024,5.542168675,-8.561643836,4.993757803
1248,1009,856,927,952,1029,1012,1075,1054,71,25,77,-17,63,-21,8.294392523,2.696871629,8.088235294,-1.652089407,6.225296443,-1.953488372
1249,556,1757,1741,1722,1807,1920,2138,2357,-16,-19,85,113,218,219,-0.910643142,-1.091326824,4.93612079,6.253458771,11.35416667,10.24321796
1250,9,1425,1387,1393,1440,1456,1521,1602,-38,6,47,16,65,81,-2.666666667,0.43258832,3.374012922,1.111111111,4.464285714,5.325443787
1251,3,2070,2059,2077,2163,2250,2337,2450,-11,18,86,87,87,113,-0.531400966,0.874210782,4.140587386,4.022191401,3.866666667,4.835258879
1252,47,3143,2892,2961,3360,3952,4412,4333,-251,69,399,592,460,-79,-7.986000636,2.385892116,13.4751773,17.61904762,11.63967611,-1.79057117
1253,1774,1185,1124,1105,1196,1219,1305,1282,-61,-19,91,23,86,-23,-5.147679325,-1.690391459,8.235294118,1.923076923,7.054963084,-1.762452107
1254,63,1353,1321,1321,1344,1392,1439,1581,-32,0,23,48,47,142,-2.36511456,0,1.741105223,3.571428571,3.376436782,9.867963864
1255,984,1344,1378,1375,1408,1473,1646,1801,34,-3,33,65,173,155,2.529761905,-0.217706821,2.4,4.616477273,11.74473863,9.416767922
1256,165,2089,1758,1800,1796,2011,2223,2379,-331,42,-4,215,212,156,-15.84490187,2.389078498,-0.222222222,11.97104677,10.5420189,7.01754386
1257,61,2584,2844,2916,3050,3544,3980,3971,260,72,134,494,436,-9,10.0619195,2.53164557,4.595336077,16.19672131,12.30248307,-0.226130653
1258,1976,1235,1237,1674,1594,1662,2039,2412,2,437,-80,68,377,373,0.16194332,35.32740501,-4.778972521,4.265997491,22.68351384,18.29328102
1259,2030,1086,1165,987,1125,1057,1055,1100,79,-178,138,-68,-2,45,7.274401473,-15.27896996,13.98176292,-6.044444444,-0.189214759,4.265402844
1260,1462,1083,1042,1078,1334,1228,1316,1321,-41,36,256,-106,88,5,-3.78578024,3.454894434,23.74768089,-7.946026987,7.166123779,0.37993921
1261,521,899,897,905,929,996,999,1002,-2,8,24,67,3,3,-0.22246941,0.891861761,2.651933702,7.212055974,0.301204819,0.3003003
1262,1583,900,829,737,774,759,846,885,-71,-92,37,-15,87,39,-7.888888889,-11.09770808,5.020352782,-1.937984496,11.46245059,4.609929078
1263,13,2440,2490,2562,2719,3189,3466,3527,50,72,157,470,277,61,2.049180328,2.891566265,6.12802498,17.28576683,8.686108498,1.759953837
1264,614,1008,1018,993,775,895,973,1003,10,-25,-218,120,78,30,0.992063492,-2.455795678,-21.95367573,15.48387097,8.715083799,3.083247688
1265,170,2256,2138,2186,2069,2563,2877,2925,-118,48,-117,494,314,48,-5.230496454,2.245088868,-5.352241537,23.87626873,12.25126805,1.668404588
1266,1291,1058,1124,1139,1209,1208,1247,1289,66,15,70,-1,39,42,6.238185255,1.334519573,6.145741879,-0.082712986,3.228476821,3.3680834
1267,1204,1900,1614,1661,1838,1970,1763,1867,-286,47,177,132,-207,104,-15.05263158,2.912019827,10.65623119,7.18171926,-10.50761421,5.899035735
1268,193,1644,1718,1682,1732,1680,1733,1864,74,-36,50,-52,53,131,4.501216545,-2.095459837,2.972651605,-3.002309469,3.154761905,7.55914599
1269,264,1215,1216,1237,1304,1299,1310,1362,1,21,67,-5,11,52,0.082304527,1.726973684,5.41632983,-0.383435583,0.846805235,3.969465649
1270,270,1500,1364,1399,1365,1401,1385,1470,-136,35,-34,36,-16,85,-9.066666667,2.565982405,-2.430307362,2.637362637,-1.142041399,6.137184116
1271,771,1321,1424,1457,1494,1521,1410,1411,103,33,37,27,-111,1,7.797123391,2.31741573,2.539464653,1.807228916,-7.297830375,0.070921986
1272,2895,1187,1087,1215,1252,1166,1188,922,-100,128,37,-86,22,-266,-8.424599832,11.77552898,3.04526749,-6.869009585,1.886792453,-22.39057239
1273,942,1311,1408,1443,1414,1498,1394,1419,97,35,-29,84,-104,25,7.398932113,2.485795455,-2.00970201,5.940594059,-6.94259012,1.793400287
1274,282,851,831,887,879,715,805,810,-20,56,-8,-164,90,5,-2.350176263,6.738868833,-0.901916573,-18.65756542,12.58741259,0.621118012
1275,435,771,826,824,812,852,886,893,55,-2,-12,40,34,7,7.133592737,-0.242130751,-1.45631068,4.926108374,3.990610329,0.79006772
1276,249,1088,1065,963,1180,1196,1235,1251,-23,-102,217,16,39,16,-2.113970588,-9.577464789,22.5337487,1.355932203,3.260869565,1.295546559
1277,2206,850,813,784,854,858,863,847,-37,-29,70,4,5,-16,-4.352941176,-3.56703567,8.928571429,0.468384075,0.582750583,-1.853997683
1278,1549,1117,1177,1031,1193,1223,1248,1274,60,-146,162,30,25,26,5.371530886,-12.40441801,15.7129001,2.514668902,2.04415372,2.083333333
1279,309,1442,1571,1633,1670,1666,1632,1770,129,62,37,-4,-34,138,8.94590846,3.946530872,2.265768524,-0.239520958,-2.040816327,8.455882353
1280,2294,928,938,961,959,975,939,941,10,23,-2,16,-36,2,1.077586207,2.452025586,-0.208116545,1.668404588,-3.692307692,0.212992545
1281,2270,904,914,928,937,957,978,992,10,14,9,20,21,14,1.10619469,1.531728665,0.969827586,2.134471718,2.194357367,1.431492843
1282,314,799,812,872,917,861,863,888,13,60,45,-56,2,25,1.627033792,7.389162562,5.160550459,-6.106870229,0.232288037,2.896871379
1283,1191,899,1053,1050,937,1040,1078,1049,154,-3,-113,103,38,-29,17.13014461,-0.284900285,-10.76190476,10.99252935,3.653846154,-2.690166976
1284,1199,1221,1235,1284,1355,1369,1444,1481,14,49,71,14,75,37,1.146601147,3.967611336,5.529595016,1.033210332,5.478451424,2.56232687
1285,2384,933,902,896,901,884,845,859,-31,-6,5,-17,-39,14,-3.32261522,-0.66518847,0.558035714,-1.886792453,-4.411764706,1.656804734
1286,841,669,666,716,745,738,759,747,-3,50,29,-7,21,-12,-0.448430493,7.507507508,4.05027933,-0.939597315,2.845528455,-1.581027668
1287,743,1339,1393,1410,1322,1447,1338,1327,54,17,-88,125,-109,-11,4.032860344,1.220387653,-6.241134752,9.455370651,-7.532826538,-0.822122571
1288,545,827,851,868,864,901,934,944,24,17,-4,37,33,10,2.902055623,1.997649824,-0.460829493,4.282407407,3.662597114,1.070663812
1289,666,777,813,793,777,840,887,840,36,-20,-16,63,47,-47,4.633204633,-2.4600246,-2.017654477,8.108108108,5.595238095,-5.298759865
1290,1381,1079,950,984,1063,1076,1127,1248,-129,34,79,13,51,121,-11.95551437,3.578947368,8.028455285,1.222953904,4.739776952,10.7364685
1291,968,1020,1097,1014,1077,1178,1220,1272,77,-83,63,101,42,52,7.549019608,-7.566089335,6.213017751,9.377901578,3.565365025,4.262295082
1292,2988,994,995,1000,1003,1085,1017,958,1,5,3,82,-68,-59,0.100603622,0.502512563,0.3,8.175473579,-6.267281106,-5.801376598
1293,962,736,723,713,761,758,767,782,-13,-10,48,-3,9,15,-1.766304348,-1.383125864,6.732117812,-0.394218134,1.187335092,1.955671447
1294,233,1336,1176,1120,1192,1238,1275,1265,-160,-56,72,46,37,-10,-11.9760479,-4.761904762,6.428571429,3.859060403,2.988691438,-0.784313725
1295,1270,823,941,966,973,955,981,992,118,25,7,-18,26,11,14.33778858,2.65674814,0.724637681,-1.849948613,2.722513089,1.121304791
1296,337,806,944,805,984,965,1039,1110,138,-139,179,-19,74,71,17.12158809,-14.72457627,22.23602484,-1.930894309,7.668393782,6.833493744
1297,219,1171,1260,1266,1359,1397,1405,1366,89,6,93,38,8,-39,7.600341588,0.476190476,7.345971564,2.796173657,0.572655691,-2.775800712
1298,1574,949,879,891,993,1016,1013,1040,-70,12,102,23,-3,27,-7.376185458,1.365187713,11.44781145,2.316213494,-0.295275591,2.665350444
1299,1594,1159,1188,1097,1204,1178,1253,1323,29,-91,107,-26,75,70,2.502157032,-7.65993266,9.753874202,-2.159468439,6.36672326,5.586592179
1300,598,984,967,950,997,1080,1113,1106,-17,-17,47,83,33,-7,-1.727642276,-1.758014478,4.947368421,8.324974925,3.055555556,-0.628930818
1301,35,1033,1004,972,994,1022,1031,1031,-29,-32,22,28,9,0,-2.807357212,-3.187250996,2.263374486,2.816901408,0.880626223,0
1302,673,1171,1104,1150,954,1009,1071,1092,-67,46,-196,55,62,21,-5.721605465,4.166666667,-17.04347826,5.765199161,6.144697721,1.960784314
1303,412,1285,1296,1357,1398,1395,1429,1446,11,61,41,-3,34,17,0.856031128,4.706790123,3.021370671,-0.214592275,2.437275986,1.189643107
1304,1437,1060,771,775,811,856,937,946,-289,4,36,45,81,9,-27.26415094,0.518806744,4.64516129,5.548705302,9.462616822,0.960512273
1305,2727,1195,1143,1163,1146,1201,1238,1180,-52,20,-17,55,37,-58,-4.351464435,1.749781277,-1.461736887,4.79930192,3.080766028,-4.684975767
1306,2121,863,955,941,863,835,833,841,92,-14,-78,-28,-2,8,10.66048667,-1.465968586,-8.289054198,-3.244495944,-0.239520958,0.960384154
1307,1898,911,912,921,870,924,922,970,1,9,-51,54,-2,48,0.109769484,0.986842105,-5.537459283,6.206896552,-0.216450216,5.206073753
1308,641,1315,1340,1369,1010,1051,1329,1325,25,29,-359,41,278,-4,1.901140684,2.164179104,-26.22352082,4.059405941,26.45099905,-0.300978179
1309,331,1268,1197,1257,1262,1270,1431,1564,-71,60,5,8,161,133,-5.599369085,5.012531328,0.397772474,0.633914422,12.67716535,9.29419986
1310,1056,1283,1339,1311,1325,1337,1397,1511,56,-28,14,12,60,114,4.36477007,-2.091112771,1.067887109,0.905660377,4.487658938,8.160343593
1311,1250,1206,1259,1085,1147,1194,1233,1237,53,-174,62,47,39,4,4.394693201,-13.82049245,5.714285714,4.097646033,3.266331658,0.324412003
1312,779,1093,1030,1082,989,1020,1022,1001,-63,52,-93,31,2,-21,-5.763952425,5.048543689,-8.595194085,3.134479272,0.196078431,-2.054794521
1313,62,1497,1507,1558,1695,1771,1892,2047,10,51,137,76,121,155,0.668002672,3.384207034,8.793324775,4.483775811,6.832298137,8.192389006
1314,697,1158,1120,1162,1187,1212,1191,1200,-38,42,25,25,-21,9,-3.281519862,3.75,2.151462995,2.106149958,-1.732673267,0.755667506
1315,2079,969,1011,989,1043,1063,1046,1048,42,-22,54,20,-17,2,4.334365325,-2.176063304,5.460060667,1.917545542,-1.599247413,0.191204589
1316,117,1623,1603,1623,1662,1750,1892,2013,-20,20,39,88,142,121,-1.23228589,1.247660636,2.402957486,5.294825511,8.114285714,6.395348837
1317,828,1215,1216,1303,1270,1245,1286,1227,1,87,-33,-25,41,-59,0.082304527,7.154605263,-2.532617038,-1.968503937,3.293172691,-4.587869362
1318,140,2286,2229,2176,2233,2229,2361,2289,-57,-53,57,-4,132,-72,-2.49343832,-2.377747869,2.619485294,-0.179131214,5.921938089,-3.049555273
1319,443,896,915,974,969,963,972,972,19,59,-5,-6,9,0,2.120535714,6.448087432,-0.513347023,-0.619195046,0.934579439,0
1320,2392,1302,1280,1310,1369,1484,1580,1545,-22,30,59,115,96,-35,-1.689708141,2.34375,4.503816794,8.400292184,6.469002695,-2.215189873
1321,99,1883,1786,1818,1934,2240,2437,2585,-97,32,116,306,197,148,-5.151354222,1.791713326,6.380638064,15.8221303,8.794642857,6.073040624
1322,937,1191,1164,1205,1181,1189,1193,1180,-27,41,-24,8,4,-13,-2.267002519,3.52233677,-1.991701245,0.677392041,0.336417157,-1.089689858
1323,1465,930,818,804,851,850,840,881,-112,-14,47,-1,-10,41,-12.04301075,-1.711491443,5.845771144,-0.117508813,-1.176470588,4.880952381
1324,160,949,907,985,1062,997,1079,1134,-42,78,77,-65,82,55,-4.425711275,8.599779493,7.817258883,-6.120527307,8.224674022,5.097312326
1325,100,1150,1012,1089,1076,1141,1192,1250,-138,77,-13,65,51,58,-12,7.608695652,-1.193755739,6.040892193,4.469763365,4.865771812
1326,322,1341,1370,1394,1400,1413,1424,1448,29,24,6,13,11,24,2.16256525,1.751824818,0.430416069,0.928571429,0.778485492,1.685393258
1327,2957,637,654,779,776,849,797,684,17,125,-3,73,-52,-113,2.668759812,19.11314985,-0.385109114,9.407216495,-6.124852768,-14.17816813
1328,310,1745,1793,1793,1838,1826,1845,1852,48,0,45,-12,19,7,2.750716332,0,2.509760178,-0.652883569,1.040525739,0.379403794
1329,90,1220,1119,1130,1149,1203,1266,1358,-101,11,19,54,63,92,-8.278688525,0.983020554,1.681415929,4.699738903,5.236907731,7.266982622
1330,525,919,914,912,971,875,993,1024,-5,-2,59,-96,118,31,-0.544069641,-0.218818381,6.469298246,-9.886714727,13.48571429,3.121852971
1331,127,927,838,905,964,912,971,1003,-89,67,59,-52,59,32,-9.600862999,7.99522673,6.519337017,-5.394190871,6.469298246,3.295571576
1332,1823,907,816,834,903,881,907,967,-91,18,69,-22,26,60,-10.03307607,2.205882353,8.273381295,-2.436323367,2.951191827,6.615214994
1333,863,1070,1120,1100,1127,1086,1059,1110,50,-20,27,-41,-27,51,4.672897196,-1.785714286,2.454545455,-3.63797693,-2.486187845,4.815864023
1334,278,1200,1078,1169,1096,1221,1164,1250,-122,91,-73,125,-57,86,-10.16666667,8.441558442,-6.24465355,11.40510949,-4.668304668,7.388316151
1335,1775,963,905,885,933,940,936,976,-58,-20,48,7,-4,40,-6.022845275,-2.209944751,5.423728814,0.750267953,-0.425531915,4.273504274
1336,639,727,713,756,798,759,825,761,-14,43,42,-39,66,-64,-1.925722146,6.03085554,5.555555556,-4.887218045,8.695652174,-7.757575758
1337,1682,1133,978,933,1021,1009,1079,1147,-155,-45,88,-12,70,68,-13.68049426,-4.601226994,9.431939979,-1.175318315,6.937561943,6.302131603
1338,375,1315,1355,1391,1336,1415,1322,1307,40,36,-55,79,-93,-15,3.041825095,2.656826568,-3.953989935,5.913173653,-6.572438163,-1.134644478
1339,2649,1134,1089,1056,1068,1165,1105,1119,-45,-33,12,97,-60,14,-3.968253968,-3.03030303,1.136363636,9.082397004,-5.150214592,1.266968326
1340,654,1150,1110,1135,1121,1180,1150,1218,-40,25,-14,59,-30,68,-3.47826087,2.252252252,-1.233480176,5.263157895,-2.542372881,5.913043478
1341,2779,1090,987,979,993,989,1023,1162,-103,-8,14,-4,34,139,-9.449541284,-0.810536981,1.430030644,-0.402819738,3.437815976,13.58748778
1342,1946,839,822,845,869,850,848,802,-17,23,24,-19,-2,-46,-2.026221692,2.798053528,2.840236686,-2.186421174,-0.235294118,-5.424528302
1343,615,958,989,996,1042,1025,1040,1043,31,7,46,-17,15,3,3.235908142,0.707785642,4.618473896,-1.631477927,1.463414634,0.288461538
1344,1038,783,791,855,902,946,889,912,8,64,47,44,-57,23,1.021711367,8.09102402,5.497076023,4.87804878,-6.025369979,2.587176603
1345,1713,997,915,833,847,832,858,893,-82,-82,14,-15,26,35,-8.224674022,-8.961748634,1.680672269,-1.770956316,3.125,4.079254079
1346,2264,955,843,856,1043,1048,1001,1095,-112,13,187,5,-47,94,-11.72774869,1.542111507,21.84579439,0.479386385,-4.484732824,9.390609391
1347,1142,1242,1201,1230,1226,1292,1321,1397,-41,29,-4,66,29,76,-3.301127214,2.414654455,-0.325203252,5.383360522,2.244582043,5.75321726
1348,1327,1332,1369,1421,1544,1485,1652,1739,37,52,123,-59,167,87,2.777777778,3.798392988,8.655876144,-3.821243523,11.24579125,5.266343826
1349,421,1433,1491,1461,1497,1474,1533,1486,58,-30,36,-23,59,-47,4.047452896,-2.012072435,2.464065708,-1.536406146,4.002713704,-3.065883888
1350,59,1638,1995,2190,2348,2408,2472,2516,357,195,158,60,64,44,21.79487179,9.77443609,7.214611872,2.555366269,2.657807309,1.779935275
1351,1580,1226,1251,1276,1260,1246,1315,1341,25,25,-16,-14,69,26,2.039151713,1.998401279,-1.253918495,-1.111111111,5.537720706,1.977186312
1352,444,1425,1157,1125,1158,1223,1293,1258,-268,-32,33,65,70,-35,-18.80701754,-2.765773552,2.933333333,5.613126079,5.723630417,-2.706883217
1353,1120,1200,1154,1206,1152,1197,1183,1140,-46,52,-54,45,-14,-43,-3.833333333,4.506065858,-4.47761194,3.90625,-1.169590643,-3.634826712
1354,1286,883,720,807,900,874,869,849,-163,87,93,-26,-5,-20,-18.45979615,12.08333333,11.52416357,-2.888888889,-0.57208238,-2.301495972
1355,81,1186,962,1032,1067,1053,1121,1092,-224,70,35,-14,68,-29,-18.88701518,7.276507277,3.391472868,-1.312089972,6.457739791,-2.586975914
1356,1813,705,761,809,801,775,762,750,56,48,-8,-26,-13,-12,7.943262411,6.307490145,-0.988875155,-3.245942572,-1.677419355,-1.57480315
1357,257,1119,1190,1190,1242,1312,1425,1466,71,0,52,70,113,41,6.344950849,0,4.369747899,5.636070853,8.612804878,2.877192982
1358,350,850,876,927,917,853,816,795,26,51,-10,-64,-37,-21,3.058823529,5.821917808,-1.078748652,-6.979280262,-4.337631887,-2.573529412
1359,462,941,940,963,981,989,984,956,-1,23,18,8,-5,-28,-0.106269926,2.446808511,1.869158879,0.815494393,-0.505561173,-2.845528455
1360,2548,1100,1096,1168,1174,1155,1160,1171,-4,72,6,-19,5,11,-0.363636364,6.569343066,0.51369863,-1.618398637,0.432900433,0.948275862
1361,659,1336,1219,1271,1262,1190,1157,1177,-117,52,-9,-72,-33,20,-8.75748503,4.265791632,-0.708103855,-5.705229794,-2.773109244,1.72860847
1362,215,1500,1264,1310,1243,1358,1378,1416,-236,46,-67,115,20,38,-15.73333333,3.639240506,-5.114503817,9.251810137,1.47275405,2.757619739
1363,281,1675,1592,1565,1679,1677,1753,1806,-83,-27,114,-2,76,53,-4.955223881,-1.695979899,7.284345048,-0.119118523,4.531902206,3.023388477
1364,390,1344,1340,1337,1229,1294,1298,1395,-4,-3,-108,65,4,97,-0.297619048,-0.223880597,-8.077786088,5.288852726,0.309119011,7.473035439
1365,1601,987,1011,1047,1097,1057,1109,1111,24,36,50,-40,52,2,2.431610942,3.560830861,4.775549188,-3.646308113,4.919583728,0.180342651
1366,1016,1132,989,944,1019,1006,1076,1090,-143,-45,75,-13,70,14,-12.63250883,-4.550050556,7.944915254,-1.27576055,6.958250497,1.301115242
1367,2688,948,927,931,918,924,944,981,-21,4,-13,6,20,37,-2.215189873,0.431499461,-1.396348013,0.653594771,2.164502165,3.919491525
1368,714,1500,1464,1556,1514,1607,1643,1604,-36,92,-42,93,36,-39,-2.4,6.284153005,-2.699228792,6.142668428,2.240199129,-2.373706634
1369,2822,929,888,889,898,902,930,967,-41,1,9,4,28,37,-4.413347686,0.112612613,1.012373453,0.445434298,3.10421286,3.978494624
1370,1399,947,948,922,965,909,923,894,1,-26,43,-56,14,-29,0.105596621,-2.742616034,4.663774403,-5.803108808,1.540154015,-3.141928494
1371,1523,829,837,819,842,883,952,947,8,-18,23,41,69,-5,0.965018094,-2.150537634,2.808302808,4.86935867,7.814269536,-0.525210084
1372,12,1241,1242,1255,1314,1354,1396,1470,1,13,59,40,42,74,0.080580177,1.046698873,4.701195219,3.04414003,3.101920236,5.300859599
1373,1793,957,954,986,997,968,958,950,-3,32,11,-29,-10,-8,-0.313479624,3.354297694,1.115618661,-2.908726179,-1.033057851,-0.835073069
1374,855,895,875,849,862,855,857,889,-20,-26,13,-7,2,32,-2.234636872,-2.971428571,1.531213192,-0.812064965,0.233918129,3.733955659
1375,1321,976,880,925,973,1001,1038,1038,-96,45,48,28,37,0,-9.836065574,5.113636364,5.189189189,2.877697842,3.696303696,0
1376,637,976,973,943,954,936,995,968,-3,-30,11,-18,59,-27,-0.307377049,-3.083247688,1.166489926,-1.886792453,6.303418803,-2.713567839
1377,504,1269,1223,978,982,1044,1099,1125,-46,-245,4,62,55,26,-3.624901497,-20.03270646,0.408997955,6.313645621,5.268199234,2.365787079
1378,870,1119,1195,1180,1274,1323,1339,1448,76,-15,94,49,16,109,6.791778374,-1.255230126,7.966101695,3.846153846,1.209372638,8.140403286
1379,1341,1166,1139,1173,1220,1339,1271,1034,-27,34,47,119,-68,-237,-2.315608919,2.985074627,4.006820119,9.754098361,-5.078416729,-18.64673485
1380,2595,921,918,898,885,881,874,896,-3,-20,-13,-4,-7,22,-0.325732899,-2.178649237,-1.44766147,-0.451977401,-0.794551646,2.517162471
1381,2860,947,926,935,940,960,993,935,-21,9,5,20,33,-58,-2.217529039,0.971922246,0.534759358,2.127659574,3.4375,-5.840886203
1382,1572,1028,892,754,962,947,941,929,-136,-138,208,-15,-6,-12,-13.22957198,-15.47085202,27.5862069,-1.559251559,-0.633579725,-1.275239107
1383,175,1297,1338,1350,1385,1395,1440,1508,41,12,35,10,45,68,3.161141095,0.896860987,2.592592593,0.722021661,3.225806452,4.722222222
1384,1613,980,993,994,986,1049,1019,1045,13,1,-8,63,-30,26,1.326530612,0.100704935,-0.804828974,6.389452333,-2.85986654,2.551521099
1385,843,1182,1202,1231,1257,1343,1444,1579,20,29,26,86,101,135,1.692047377,2.412645591,2.112103981,6.841686555,7.520476545,9.349030471
1386,585,1347,1415,1445,1418,1518,1400,1402,68,30,-27,100,-118,2,5.048255382,2.120141343,-1.868512111,7.052186178,-7.773386034,0.142857143
1387,674,1164,1117,1134,1109,1162,1099,1108,-47,17,-25,53,-63,9,-4.037800687,1.521933751,-2.204585538,4.779080252,-5.421686747,0.818926297
1388,1273,1171,902,957,1006,1013,1110,1130,-269,55,49,7,97,20,-22.97181896,6.097560976,5.120167189,0.69582505,9.575518263,1.801801802
1389,2094,971,911,873,982,995,985,1025,-60,-38,109,13,-10,40,-6.179196704,-4.171240395,12.48568156,1.323828921,-1.005025126,4.060913706
1390,520,990,1005,1018,1062,1076,1102,1097,15,13,44,14,26,-5,1.515151515,1.293532338,4.322200393,1.31826742,2.416356877,-0.453720508
1391,2581,859,844,839,813,826,843,870,-15,-5,-26,13,17,27,-1.746216531,-0.592417062,-3.098927294,1.59901599,2.05811138,3.202846975
1392,275,1556,1666,1600,1605,1570,1666,1631,110,-66,5,-35,96,-35,7.06940874,-3.961584634,0.3125,-2.180685358,6.114649682,-2.100840336
1393,1348,1032,1043,1058,1190,1129,1235,1199,11,15,132,-61,106,-36,1.065891473,1.438159156,12.47637051,-5.12605042,9.388839681,-2.914979757
1394,366,1476,1524,1580,1445,1579,1636,1601,48,56,-135,134,57,-35,3.25203252,3.674540682,-8.544303797,9.273356401,3.609879671,-2.139364303
1395,2193,969,963,975,953,953,930,959,-6,12,-22,0,-23,29,-0.619195046,1.246105919,-2.256410256,0,-2.41343127,3.11827957
1396,1964,1187,1114,1044,1078,1060,1093,1265,-73,-70,34,-18,33,172,-6.149957877,-6.283662478,3.256704981,-1.669758813,3.113207547,15.73650503
1397,2661,1050,974,974,1002,1095,1071,1038,-76,0,28,93,-24,-33,-7.238095238,0,2.874743326,9.281437126,-2.191780822,-3.081232493
1398,1167,1354,1445,1513,1613,1728,1801,1839,91,68,100,115,73,38,6.720827179,4.705882353,6.609385327,7.129572226,4.224537037,2.109938923
1399,1937,1036,1013,923,900,972,932,982,-23,-90,-23,72,-40,50,-2.22007722,-8.884501481,-2.491874323,8,-4.115226337,5.364806867
1400,2542,1015,986,957,1000,1103,1061,1080,-29,-29,43,103,-42,19,-2.857142857,-2.941176471,4.493207941,10.3,-3.807796917,1.790763431
1401,1935,1142,1093,1078,1139,1136,1169,1162,-49,-15,61,-3,33,-7,-4.290718039,-1.372369625,5.658627087,-0.263388938,2.904929577,-0.598802395
1402,1454,918,790,809,813,800,802,792,-128,19,4,-13,2,-10,-13.94335512,2.405063291,0.494437577,-1.59901599,0.25,-1.246882793
1403,200,799,819,678,665,736,697,775,20,-141,-13,71,-39,78,2.503128911,-17.21611722,-1.91740413,10.67669173,-5.298913043,11.19081779
1404,106,1224,1131,1146,1105,1149,1141,1177,-93,15,-41,44,-8,36,-7.598039216,1.326259947,-3.577661431,3.981900452,-0.696257615,3.155127082
1405,74,975,988,1058,1088,1103,1110,1106,13,70,30,15,7,-4,1.333333333,7.085020243,2.835538752,1.378676471,0.63463282,-0.36036036
1406,2742,755,753,782,824,818,835,834,-2,29,42,-6,17,-1,-0.264900662,3.85126162,5.37084399,-0.72815534,2.078239609,-0.119760479
1407,553,1401,1343,1315,1265,1231,1315,1398,-58,-28,-50,-34,84,83,-4.139900071,-2.084884587,-3.802281369,-2.687747036,6.823720552,6.311787072
1408,2377,940,919,927,912,914,887,912,-21,8,-15,2,-27,25,-2.234042553,0.870511425,-1.618122977,0.219298246,-2.95404814,2.81848929
1409,398,837,866,903,953,971,1017,1020,29,37,50,18,46,3,3.464755078,4.272517321,5.53709856,1.888772298,4.73738414,0.294985251
1410,2064,1015,1009,1009,1071,1116,1134,1151,-6,0,62,45,18,17,-0.591133005,0,6.144697721,4.201680672,1.612903226,1.499118166
1411,451,983,993,1014,1043,1109,1084,1163,10,21,29,66,-25,79,1.017293998,2.114803625,2.859960552,6.327900288,-2.254283138,7.287822878
1412,943,810,853,834,834,869,870,899,43,-19,0,35,1,29,5.308641975,-2.227432591,0,4.196642686,0.115074799,3.333333333
1413,2573,964,990,1045,1111,1112,1161,1136,26,55,66,1,49,-25,2.697095436,5.555555556,6.315789474,0.090009001,4.40647482,-2.153316107
1414,1849,1105,1025,1002,1060,1086,1137,1211,-80,-23,58,26,51,74,-7.239819005,-2.243902439,5.788423154,2.452830189,4.696132597,6.508355321
1415,2733,900,855,856,857,901,905,864,-45,1,1,44,4,-41,-5,0.116959064,0.11682243,5.134189032,0.443951165,-4.53038674
1416,2685,874,807,759,867,885,862,863,-67,-48,108,18,-23,1,-7.66590389,-5.94795539,14.22924901,2.076124567,-2.598870056,0.116009281
1417,2194,1106,1177,1113,1097,1187,1195,1215,71,-64,-16,90,8,20,6.419529837,-5.437553101,-1.437556155,8.204193254,0.673967987,1.673640167
1418,208,1199,1203,1237,1298,1359,1391,1442,4,34,61,61,32,51,0.333611343,2.826267664,4.931285368,4.69953775,2.354672553,3.666427031
1419,84,1703,1628,1695,1845,1941,1989,2043,-75,67,150,96,48,54,-4.403992954,4.115479115,8.849557522,5.203252033,2.472952087,2.714932127
1420,574,1200,1177,1206,1274,1296,1344,1361,-23,29,68,22,48,17,-1.916666667,2.463891249,5.638474295,1.726844584,3.703703704,1.264880952
1421,1620,1218,1204,1192,1247,1240,1248,1269,-14,-12,55,-7,8,21,-1.149425287,-0.996677741,4.61409396,-0.561347233,0.64516129,1.682692308
1422,1811,922,886,977,946,958,951,918,-36,91,-31,12,-7,-33,-3.904555315,10.27088036,-3.172978506,1.268498943,-0.730688935,-3.470031546
1423,1764,892,886,883,879,882,848,852,-6,-3,-4,3,-34,4,-0.67264574,-0.338600451,-0.453001133,0.341296928,-3.854875283,0.471698113
1424,1536,1005,991,1031,1086,1090,1154,1191,-14,40,55,4,64,37,-1.393034826,4.036326942,5.334626576,0.368324125,5.871559633,3.206239168
1425,961,750,775,829,880,833,867,839,25,54,51,-47,34,-28,3.333333333,6.967741935,6.15199035,-5.340909091,4.081632653,-3.229527105
1426,802,800,847,867,847,892,891,898,47,20,-20,45,-1,7,5.875,2.361275089,-2.306805075,5.312868949,-0.112107623,0.785634119
1427,1517,1222,1133,1137,1081,1150,1204,1215,-89,4,-56,69,54,11,-7.28314239,0.353045013,-4.925241865,6.382978723,4.695652174,0.913621262
1428,635,852,864,897,917,863,866,905,12,33,20,-54,3,39,1.408450704,3.819444444,2.229654404,-5.888767721,0.347624565,4.503464203
1429,1268,912,899,886,852,863,895,888,-13,-13,-34,11,32,-7,-1.425438596,-1.446051168,-3.837471783,1.291079812,3.707995365,-0.782122905
1430,45,2244,2234,2271,2355,2413,2513,2588,-10,37,84,58,100,75,-0.445632799,1.656222023,3.698811096,2.462845011,4.144218815,2.9844807
1431,1488,1105,1193,1141,1152,1231,1206,1084,88,-52,11,79,-25,-122,7.963800905,-4.35875943,0.964066608,6.857638889,-2.030869212,-10.11608624
1432,2670,761,748,742,739,773,744,746,-13,-6,-3,34,-29,2,-1.708278581,-0.802139037,-0.404312668,4.600811908,-3.751617076,0.268817204
1433,2010,1083,1169,1128,1195,1139,1034,1102,86,-41,67,-56,-105,68,7.940904894,-3.507271172,5.939716312,-4.686192469,-9.218612818,6.576402321
1434,1352,822,760,643,693,799,713,736,-62,-117,50,106,-86,23,-7.542579075,-15.39473684,7.776049767,15.2958153,-10.76345432,3.225806452
1435,897,1258,1531,1392,1343,1167,1252,1215,273,-139,-49,-176,85,-37,21.70111288,-9.079033312,-3.520114943,-13.10498883,7.283633248,-2.955271565
1436,109,1491,1506,1514,1523,1555,1563,1551,15,8,9,32,8,-12,1.006036217,0.531208499,0.594451783,2.101116218,0.514469453,-0.767754319
1437,1192,1110,1011,1044,1138,1191,1224,1293,-99,33,94,53,33,69,-8.918918919,3.264094955,9.003831418,4.657293497,2.770780856,5.637254902
1438,464,994,998,1112,1140,1184,1171,1155,4,114,28,44,-13,-16,0.402414487,11.42284569,2.517985612,3.859649123,-1.097972973,-1.366353544
1439,1143,1227,1202,1203,1253,1282,1331,1389,-25,1,50,29,49,58,-2.037489813,0.083194676,4.156275977,2.314445331,3.822152886,4.357625845
1440,40,1290,1291,1302,1344,1383,1438,1484,1,11,42,39,55,46,0.07751938,0.852052672,3.225806452,2.901785714,3.976861894,3.198887344
1441,1724,1119,1124,980,1049,1113,1043,1074,5,-144,69,64,-70,31,0.446827525,-12.8113879,7.040816327,6.101048618,-6.289308176,2.97219559
1442,1448,917,897,902,935,912,904,952,-20,5,33,-23,-8,48,-2.181025082,0.557413601,3.658536585,-2.459893048,-0.877192982,5.309734513
1443,1449,1220,1122,1148,1219,1276,1293,1294,-98,26,71,57,17,1,-8.032786885,2.317290553,6.18466899,4.675963905,1.332288401,0.07733952
1444,537,1271,1226,1211,1179,1257,1288,1266,-45,-15,-32,78,31,-22,-3.540519276,-1.223491028,-2.642444261,6.615776081,2.46618934,-1.708074534
1445,1582,1260,1230,1260,1441,1433,1539,1529,-30,30,181,-8,106,-10,-2.380952381,2.43902439,14.36507937,-0.555170021,7.397069086,-0.64977258
1446,1503,1345,1473,1481,1611,1746,1813,1912,128,8,130,135,67,99,9.516728625,0.543109301,8.777852802,8.379888268,3.837342497,5.460562603
1447,1392,1074,1058,1050,1054,1181,1191,1212,-16,-8,4,127,10,21,-1.489757914,-0.756143667,0.380952381,12.04933586,0.846740051,1.763224181
1448,2676,1056,1050,1022,1089,1109,1172,990,-6,-28,67,20,63,-182,-0.568181818,-2.666666667,6.555772994,1.836547291,5.680793508,-15.52901024
1449,1650,889,901,919,928,900,847,849,12,18,9,-28,-53,2,1.349831271,1.997780244,0.979325354,-3.017241379,-5.888888889,0.236127509
1450,625,1199,1213,1178,1198,1203,1247,1226,14,-35,20,5,44,-21,1.1676397,-2.885408079,1.697792869,0.41736227,3.65752286,-1.6840417
1451,2502,1182,1119,1157,980,964,958,964,-63,38,-177,-16,-6,6,-5.329949239,3.395889187,-15.29818496,-1.632653061,-0.622406639,0.626304802
1452,342,1000,1048,1040,1041,1115,1189,1190,48,-8,1,74,74,1,4.8,-0.763358779,0.096153846,7.108549472,6.6367713,0.084104289
1453,1537,949,869,863,1036,1093,1100,1105,-80,-6,173,57,7,5,-8.429926238,-0.690448792,20.04634994,5.501930502,0.640439158,0.454545455
1454,905,1021,979,1007,1003,960,1004,986,-42,28,-4,-43,44,-18,-4.113614104,2.860061287,-0.397219464,-4.287138584,4.583333333,-1.792828685
1455,345,1669,1586,1624,1648,1734,1683,1664,-83,38,24,86,-51,-19,-4.973037747,2.395964691,1.477832512,5.218446602,-2.941176471,-1.128936423
1456,198,1292,1455,1491,1530,1515,1531,1593,163,36,39,-15,16,62,12.61609907,2.474226804,2.615694165,-0.980392157,1.056105611,4.049640758
1457,1599,1038,973,1019,1049,1054,990,1009,-65,46,30,5,-64,19,-6.262042389,4.727646454,2.944062807,0.476644423,-6.072106262,1.919191919
1458,717,1183,1205,1287,1305,1290,1294,1309,22,82,18,-15,4,15,1.859678783,6.804979253,1.398601399,-1.149425287,0.310077519,1.159196291
1459,1482,1172,1056,1035,1161,1188,1277,1259,-116,-21,126,27,89,-18,-9.897610922,-1.988636364,12.17391304,2.325581395,7.491582492,-1.409553641
1460,845,1042,1085,1103,1101,1155,1268,1366,43,18,-2,54,113,98,4.126679463,1.658986175,-0.181323663,4.904632153,9.783549784,7.728706625
1461,980,811,980,1013,973,925,899,962,169,33,-40,-48,-26,63,20.83847102,3.367346939,-3.948667325,-4.9331963,-2.810810811,7.007786429
1462,206,958,1027,1086,1129,1209,1198,1228,69,59,43,80,-11,30,7.202505219,5.744888023,3.959484346,7.08591674,-0.909842845,2.504173623
1463,2228,1104,912,978,1003,1090,1100,1091,-192,66,25,87,10,-9,-17.39130435,7.236842105,2.556237219,8.673978066,0.917431193,-0.818181818
1464,2517,1255,1213,1213,1195,1137,1168,1105,-42,0,-18,-58,31,-63,-3.346613546,0,-1.483924155,-4.853556485,2.726473175,-5.393835616
1465,283,1106,1133,1171,1195,1183,1203,1202,27,38,24,-12,20,-1,2.441229656,3.353927626,2.049530316,-1.0041841,1.690617075,-0.08312552
1466,183,1434,1562,1558,1590,1635,1689,1688,128,-4,32,45,54,-1,8.926080893,-0.256081946,2.053915276,2.830188679,3.302752294,-0.059206631
1467,921,1200,1180,1198,1200,1227,1246,1291,-20,18,2,27,19,45,-1.666666667,1.525423729,0.166944908,2.25,1.548492258,3.611556982
1468,506,1517,1535,1609,1756,1732,1572,1592,18,74,147,-24,-160,20,1.186552406,4.820846906,9.136109385,-1.366742597,-9.237875289,1.272264631
1469,516,930,926,939,993,1012,1081,1054,-4,13,54,19,69,-27,-0.430107527,1.403887689,5.750798722,1.913393756,6.818181818,-2.497687327
1470,587,805,806,819,853,896,978,938,1,13,34,43,82,-40,0.124223602,1.612903226,4.151404151,5.041031653,9.151785714,-4.08997955
1471,87,1325,1383,1375,1515,1613,1727,1845,58,-8,140,98,114,118,4.377358491,-0.578452639,10.18181818,6.468646865,7.067575945,6.832657788
1472,320,914,956,895,896,1025,951,994,42,-61,1,129,-74,43,4.595185996,-6.380753138,0.111731844,14.39732143,-7.219512195,4.521556257
1473,1684,1229,1224,1284,1332,1351,1403,1413,-5,60,48,19,52,10,-0.406834825,4.901960784,3.738317757,1.426426426,3.84900074,0.712758375
1474,115,1293,1278,1279,1349,1394,1473,1556,-15,1,70,45,79,83,-1.160092807,0.078247261,5.473025801,3.335804299,5.667144907,5.634758995
1475,1206,1538,1517,1553,1666,1732,1738,1732,-21,36,113,66,6,-6,-1.365409623,2.373104812,7.276239536,3.961584634,0.346420323,-0.345224396
1476,586,1189,1226,1206,1254,1252,1288,1288,37,-20,48,-2,36,0,3.111858705,-1.63132137,3.980099502,-0.159489633,2.875399361,0
1477,573,718,947,1046,961,1048,1002,1087,229,99,-85,87,-46,85,31.89415042,10.45406547,-8.126195029,9.053069719,-4.389312977,8.483033932
1478,2028,946,952,965,969,998,983,998,6,13,4,29,-15,15,0.634249471,1.365546218,0.414507772,2.992776058,-1.503006012,1.525940997
1479,1445,829,764,751,809,792,770,797,-65,-13,58,-17,-22,27,-7.840772014,-1.701570681,7.723035952,-2.101359703,-2.777777778,3.506493506
1480,1159,895,830,806,806,825,829,832,-65,-24,0,19,4,3,-7.262569832,-2.891566265,0,2.357320099,0.484848485,0.361881785
1481,321,850,829,860,895,848,783,834,-21,31,35,-47,-65,51,-2.470588235,3.739445115,4.069767442,-5.251396648,-7.66509434,6.513409962
1482,392,1335,1397,1438,1391,1461,1351,1388,62,41,-47,70,-110,37,4.644194757,2.934860415,-3.268428373,5.032350827,-7.529089665,2.738712065
1483,340,1066,1016,1066,1115,1133,1159,1144,-50,50,49,18,26,-15,-4.69043152,4.921259843,4.596622889,1.614349776,2.294792586,-1.294219154
1484,570,1255,1063,1034,1102,980,1232,1251,-192,-29,68,-122,252,19,-15.29880478,-2.72812794,6.576402321,-11.0707804,25.71428571,1.542207792
1485,903,1003,988,933,998,998,1065,1110,-15,-55,65,0,67,45,-1.49551346,-5.566801619,6.966773848,0,6.713426854,4.225352113
1486,1671,843,856,852,864,882,858,849,13,-4,12,18,-24,-9,1.542111507,-0.46728972,1.408450704,2.083333333,-2.721088435,-1.048951049
1487,1240,994,987,1149,1095,1206,1194,1090,-7,162,-54,111,-12,-104,-0.704225352,16.41337386,-4.699738903,10.1369863,-0.995024876,-8.710217755
1488,2806,981,947,938,937,929,950,1005,-34,-9,-1,-8,21,55,-3.465851172,-0.950369588,-0.106609808,-0.853788687,2.260495156,5.789473684
1489,2474,1037,1175,1176,1146,1079,1091,996,138,1,-30,-67,12,-95,13.30761813,0.085106383,-2.551020408,-5.846422339,1.112140871,-8.707607699
1490,1653,650,687,728,704,713,690,690,37,41,-24,9,-23,0,5.692307692,5.96797671,-3.296703297,1.278409091,-3.225806452,0
1491,1761,974,874,871,975,999,1028,1048,-100,-3,104,24,29,20,-10.26694045,-0.343249428,11.94029851,2.461538462,2.902902903,1.945525292
1492,32,3068,3003,3157,3164,3298,3495,3470,-65,154,7,134,197,-25,-2.118644068,5.128205128,0.22172949,4.235145386,5.973317162,-0.715307582
1493,131,974,902,791,798,971,945,924,-72,-111,7,173,-26,-21,-7.392197125,-12.3059867,0.884955752,21.67919799,-2.677651905,-2.222222222
1494,956,1186,1236,1279,1306,1183,1154,1140,50,43,27,-123,-29,-14,4.215851602,3.478964401,2.111024238,-9.418070444,-2.451394759,-1.213171577
1495,1704,1089,891,888,879,889,924,900,-198,-3,-9,10,35,-24,-18.18181818,-0.336700337,-1.013513514,1.137656428,3.937007874,-2.597402597
1496,1603,1111,1085,1104,1176,1198,1259,1278,-26,19,72,22,61,19,-2.340234023,1.751152074,6.52173913,1.870748299,5.091819699,1.509134234
1497,209,1351,1257,1325,1355,1386,1467,1557,-94,68,30,31,81,90,-6.95780903,5.409705648,2.264150943,2.287822878,5.844155844,6.134969325
1498,2933,1116,1080,1064,1207,1170,1230,1164,-36,-16,143,-37,60,-66,-3.225806452,-1.481481481,13.43984962,-3.065451533,5.128205128,-5.365853659
1499,2130,959,897,883,892,917,929,967,-62,-14,9,25,12,38,-6.465067779,-1.560758082,1.019252548,2.802690583,1.308615049,4.090419806
1500,448,799,811,852,894,912,885,892,12,41,42,18,-27,7,1.501877347,5.055487053,4.929577465,2.013422819,-2.960526316,0.790960452
1501,1765,1062,995,973,1026,1072,1079,1127,-67,-22,53,46,7,48,-6.308851224,-2.211055276,5.447070915,4.483430799,0.652985075,4.448563485
1502,1787,885,881,913,905,937,956,961,-4,32,-8,32,19,5,-0.451977401,3.632236095,-0.876232202,3.535911602,2.027748132,0.523012552
1503,1484,1254,1252,1262,1266,1159,1115,1079,-2,10,4,-107,-44,-36,-0.159489633,0.798722045,0.316957211,-8.451816746,-3.796376186,-3.228699552
1504,1360,949,928,778,893,906,946,1000,-21,-150,115,13,40,54,-2.212855638,-16.1637931,14.781491,1.455767077,4.415011038,5.708245243
1505,1692,1037,951,936,1017,1039,1085,1114,-86,-15,81,22,46,29,-8.293153327,-1.577287066,8.653846154,2.163225172,4.427333975,2.67281106
1506,1322,928,851,879,885,866,887,849,-77,28,6,-19,21,-38,-8.297413793,3.290246769,0.682593857,-2.146892655,2.424942263,-4.28410372
1507,380,1200,1258,1200,1198,1202,1202,1197,58,-58,-2,4,0,-5,4.833333333,-4.610492846,-0.166666667,0.333889816,0,-0.415973378
1508,2310,997,1035,1002,1081,1049,1093,999,38,-33,79,-32,44,-94,3.811434303,-3.188405797,7.884231537,-2.960222017,4.194470925,-8.600182983
1509,2128,970,943,951,965,962,994,1043,-27,8,14,-3,32,49,-2.783505155,0.84835631,1.472134595,-0.310880829,3.326403326,4.929577465
1510,2538,920,890,898,887,889,891,940,-30,8,-11,2,2,49,-3.260869565,0.898876404,-1.224944321,0.225479143,0.224971879,5.499438833
1511,1180,1657,1608,1573,1645,1674,1666,1665,-49,-35,72,29,-8,-1,-2.957151479,-2.176616915,4.577240941,1.762917933,-0.477897252,-0.06002401
1512,716,848,865,879,855,895,925,945,17,14,-24,40,30,20,2.004716981,1.61849711,-2.730375427,4.678362573,3.351955307,2.162162162
1513,1013,1476,1514,1536,1525,1516,1542,1521,38,22,-11,-9,26,-21,2.574525745,1.453104359,-0.716145833,-0.590163934,1.715039578,-1.361867704
1514,226,1874,2085,2123,2175,2335,2385,2463,211,38,52,160,50,78,11.25933831,1.822541966,2.449364107,7.356321839,2.141327623,3.270440252
1515,1200,1300,1368,1420,1487,1612,1645,1661,68,52,67,125,33,16,5.230769231,3.801169591,4.718309859,8.406186954,2.047146402,0.972644377
1516,341,1278,1356,1413,1464,1532,1604,1674,78,57,51,68,72,70,6.103286385,4.203539823,3.609341826,4.644808743,4.699738903,4.364089776
1517,1585,1252,1227,1264,1340,1400,1529,1541,-25,37,76,60,129,12,-1.996805112,3.015484923,6.012658228,4.47761194,9.214285714,0.784826684
1518,831,1200,1218,1254,1294,1284,1353,1343,18,36,40,-10,69,-10,1.5,2.955665025,3.189792663,-0.772797527,5.373831776,-0.7390983
1519,329,1340,1316,1338,1386,1404,1412,1379,-24,22,48,18,8,-33,-1.791044776,1.671732523,3.587443946,1.298701299,0.56980057,-2.337110482
1520,2899,864,867,899,898,904,938,866,3,32,-1,6,34,-72,0.347222222,3.69088812,-0.111234705,0.668151448,3.761061947,-7.675906183
1521,1062,1002,895,930,940,865,986,901,-107,35,10,-75,121,-85,-10.67864271,3.910614525,1.075268817,-7.978723404,13.98843931,-8.620689655
1522,580,1053,1097,1151,1159,1198,1234,1163,44,54,8,39,36,-71,4.178537512,4.922515953,0.695047785,3.364969802,3.005008347,-5.753646677
1523,534,1331,1286,1159,1232,1330,1278,1269,-45,-127,73,98,-52,-9,-3.380916604,-9.875583204,6.298533218,7.954545455,-3.909774436,-0.704225352
1524,680,960,953,887,951,932,954,1009,-7,-66,64,-19,22,55,-0.729166667,-6.925498426,7.215332582,-1.997896951,2.360515021,5.765199161
1525,315,1100,1025,936,1187,1118,1183,1117,-75,-89,251,-69,65,-66,-6.818181818,-8.682926829,26.81623932,-5.812973884,5.813953488,-5.579036348
1526,1595,1247,1199,1195,1227,1221,1275,1265,-48,-4,32,-6,54,-10,-3.849238172,-0.333611343,2.677824268,-0.488997555,4.422604423,-0.784313725
1527,458,710,908,937,953,929,918,945,198,29,16,-24,-11,27,27.88732394,3.193832599,1.707577375,-2.518363064,-1.184068891,2.941176471
1528,415,937,885,923,982,953,944,900,-52,38,59,-29,-9,-44,-5.549626467,4.293785311,6.39219935,-2.953156823,-0.944386149,-4.661016949
1529,1626,1309,1283,1311,1310,1222,1299,1289,-26,28,-1,-88,77,-10,-1.986249045,2.182385035,-0.076277651,-6.717557252,6.301145663,-0.769822941
1530,1800,1516,1800,1517,1495,1484,1523,1570,284,-283,-22,-11,39,47,18.73350923,-15.72222222,-1.450230719,-0.735785953,2.628032345,3.086014445
1531,924,879,792,840,854,853,948,900,-87,48,14,-1,95,-48,-9.897610922,6.060606061,1.666666667,-0.117096019,11.13716295,-5.063291139
1532,51,1473,1472,1407,1502,1496,1554,1667,-1,-65,95,-6,58,113,-0.067888663,-4.41576087,6.751954513,-0.399467377,3.877005348,7.271557272
1533,581,1413,1459,1228,1445,1451,1222,1317,46,-231,217,6,-229,95,3.255484784,-15.83276217,17.67100977,0.415224913,-15.78221916,7.774140753
1534,2229,902,918,906,910,900,889,886,16,-12,4,-10,-11,-3,1.77383592,-1.307189542,0.441501104,-1.098901099,-1.222222222,-0.337457818
1535,316,1240,1290,1317,1361,1328,1367,1463,50,27,44,-33,39,96,4.032258065,2.093023256,3.340926348,-2.42468773,2.936746988,7.022677396
1536,1878,661,754,749,754,777,791,791,93,-5,5,23,14,0,14.06959153,-0.663129973,0.667556742,3.050397878,1.801801802,0
1537,2221,783,821,847,895,852,941,907,38,26,48,-43,89,-34,4.853128991,3.166869671,5.667060213,-4.804469274,10.44600939,-3.613177471
1538,1284,718,728,744,805,799,847,849,10,16,61,-6,48,2,1.39275766,2.197802198,8.198924731,-0.745341615,6.007509387,0.236127509
1539,797,1054,1076,1024,1059,1038,1060,1029,22,-52,35,-21,22,-31,2.087286528,-4.832713755,3.41796875,-1.983002833,2.119460501,-2.924528302
1540,179,1097,1024,1019,1019,1084,1105,1139,-73,-5,0,65,21,34,-6.654512306,-0.48828125,0,6.378802748,1.937269373,3.076923077
1541,374,1106,1135,1196,1219,1287,1366,1478,29,61,23,68,79,112,2.622061483,5.374449339,1.923076923,5.578342904,6.138306138,8.199121523
1542,950,935,1018,1001,1089,995,1086,1098,83,-17,88,-94,91,12,8.877005348,-1.669941061,8.791208791,-8.631772268,9.145728643,1.104972376
1543,199,1011,1078,1143,1225,1283,1397,1439,67,65,82,58,114,42,6.627101879,6.029684601,7.174103237,4.734693878,8.885424786,3.006442377
1544,891,750,770,813,873,811,811,800,20,43,60,-62,0,-11,2.666666667,5.584415584,7.380073801,-7.101947308,0,-1.356350185
1545,2534,1176,1130,1153,1148,1194,1168,1109,-46,23,-5,46,-26,-59,-3.911564626,2.03539823,-0.433651344,4.006968641,-2.177554439,-5.051369863
1546,210,1643,1541,1569,1586,1670,1744,1917,-102,28,17,84,74,173,-6.208155813,1.817001947,1.08349267,5.296343001,4.431137725,9.919724771
1547,110,1200,1205,1213,1235,1262,1296,1281,5,8,22,27,34,-15,0.416666667,0.663900415,1.813685078,2.186234818,2.694136292,-1.157407407
1548,189,1279,1148,1248,1199,1348,1301,1274,-131,100,-49,149,-47,-27,-10.24237686,8.710801394,-3.926282051,12.42702252,-3.486646884,-2.075326672
1549,494,1709,1705,1662,1702,1709,1694,1716,-4,-43,40,7,-15,22,-0.234055003,-2.521994135,2.406738869,0.411280846,-0.877706261,1.298701299
1550,467,1276,1264,1198,1222,1252,1266,1333,-12,-66,24,30,14,67,-0.940438871,-5.221518987,2.003338898,2.454991817,1.118210863,5.292259084
1551,217,971,934,922,972,939,899,894,-37,-12,50,-33,-40,-5,-3.810504634,-1.284796574,5.422993492,-3.395061728,-4.259850905,-0.556173526
1552,1203,,,999,1116,1152,1204,1316,,,117,36,52,112,,,11.71171171,3.225806452,4.513888889,9.302325581
1553,1452,,,1241,1262,1272,1179,1156,,,21,10,-93,-23,,,1.692183723,0.792393027,-7.311320755,-1.950805768
1554,1711,,,876,1090,991,913,928,,,214,-99,-78,15,,,24.42922374,-9.082568807,-7.870837538,1.642935378
1555,730,,,1419,1391,1437,1647,1535,,,-28,46,210,-112,,,-1.973220578,3.3069734,14.61377871,-6.800242866
1556,1652,,,1182,1203,1155,1237,1225,,,21,-48,82,-12,,,1.776649746,-3.990024938,7.0995671,-0.970088925
1557,2858,,,936,866,927,901,850,,,-70,61,-26,-51,,,-7.478632479,7.043879908,-2.804746494,-5.660377358
1558,1221,,,1939,1934,2003,2026,1962,,,-5,69,23,-64,,,-0.257864879,3.567735264,1.148277584,-3.15893386
1559,348,,,1006,897,1082,1123,1172,,,-109,185,41,49,,,-10.83499006,20.62430323,3.789279113,4.363312556
1560,1433,,,926,782,900,888,920,,,-144,118,-12,32,,,-15.55075594,15.08951407,-1.333333333,3.603603604
1561,1355,,,1337,1338,1647,1604,1595,,,1,309,-43,-9,,,0.074794316,23.0941704,-2.610807529,-0.561097257
1562,1396,,,841,892,917,943,943,,,51,25,26,0,,,6.064209275,2.802690583,2.835332606,0
1563,1483,,,1094,1102,1042,1133,1180,,,8,-60,91,47,,,0.731261426,-5.444646098,8.733205374,4.148278906
1564,2435,,,866,863,871,934,1095,,,-3,8,63,161,,,-0.346420323,0.926998841,7.233065442,17.23768737
1565,2136,,,840,884,945,979,1092,,,44,61,34,113,,,5.238095238,6.900452489,3.597883598,11.54239019
1566,722,,,1247,1125,1241,1493,1479,,,-122,116,252,-14,,,-9.783480353,10.31111111,20.30620467,-0.93770931
1567,420,,,1589,1502,1496,1639,1753,,,-87,-6,143,114,,,-5.475141598,-0.399467377,9.558823529,6.955460647
1568,1182,,,1142,1173,1187,1198,1202,,,31,14,11,4,,,2.714535902,1.193520887,0.926705981,0.333889816
1569,1288,,,859,869,913,890,920,,,10,44,-23,30,,,1.164144354,5.063291139,-2.519167579,3.370786517
1570,2123,,,1034,1030,964,1016,950,,,-4,-66,52,-66,,,-0.386847195,-6.40776699,5.394190871,-6.496062992
1571,1563,,,825,882,921,937,1016,,,57,39,16,79,,,6.909090909,4.421768707,1.737242128,8.431163287
1572,312,,,1015,1011,1095,881,973,,,-4,84,-214,92,,,-0.39408867,8.308605341,-19.543379,10.44267877
1573,1605,,,1005,973,1131,1213,1291,,,-32,158,82,78,,,-3.184079602,16.23843782,7.250221043,6.430338005
1574,1358,,,949,927,982,1041,1073,,,-22,55,59,32,,,-2.318229715,5.933117584,6.00814664,3.073967339
1575,830,,,983,994,1027,1088,1095,,,11,33,61,7,,,1.119023398,3.319919517,5.93962999,0.643382353
1576,1507,,,1397,1343,1298,1336,1373,,,-54,-45,38,37,,,-3.865425913,-3.350707372,2.927580894,2.769461078
1577,1528,,,1081,1182,1102,1128,1182,,,101,-80,26,54,,,9.34320074,-6.768189509,2.359346642,4.787234043
1578,1258,,,1331,1415,1456,1541,1520,,,84,41,85,-21,,,6.311044328,2.897526502,5.837912088,-1.36275146
1579,2146,,,887,953,901,942,1061,,,66,-52,41,119,,,7.440811725,-5.456453305,4.550499445,12.63269639
1580,2181,,,1137,1008,1195,1247,1237,,,-129,187,52,-10,,,-11.34564644,18.5515873,4.351464435,-0.801924619
1581,1439,,,1010,1120,1124,1097,1060,,,110,4,-27,-37,,,10.89108911,0.357142857,-2.402135231,-3.372835005
1582,1403,,,1227,1450,1484,1489,1692,,,223,34,5,203,,,18.17440913,2.344827586,0.336927224,13.63331095
1583,2844,,,1083,1147,1205,1242,1194,,,64,58,37,-48,,,5.909510619,5.056669573,3.070539419,-3.8647343
1584,1259,,,1160,1136,1353,1444,1438,,,-24,217,91,-6,,,-2.068965517,19.10211268,6.725794531,-0.415512465
1585,786,,,1036,1323,1305,1394,1338,,,287,-18,89,-56,,,27.7027027,-1.360544218,6.819923372,-4.017216643
1586,603,,,1066,977,1059,1066,1147,,,-89,82,7,81,,,-8.348968105,8.393039918,0.661000944,7.598499062
1587,1526,,,987,1024,1072,1098,1140,,,37,48,26,42,,,3.748733536,4.6875,2.425373134,3.825136612
1588,3088,,,1196,1293,1515,1583,1253,,,97,222,68,-330,,,8.110367893,17.16937355,4.488448845,-20.846494
1589,1263,,,834,861,897,947,1047,,,27,36,50,100,,,3.237410072,4.181184669,5.574136009,10.55966209
1590,2002,,,986,1115,983,1083,1101,,,129,-132,100,18,,,13.0831643,-11.83856502,10.17293998,1.662049861
1591,2232,,,1047,1095,1178,1152,900,,,48,83,-26,-252,,,4.584527221,7.579908676,-2.20713073,-21.875
1592,1921,,,1049,1068,1166,1194,1040,,,19,98,28,-154,,,1.811248808,9.176029963,2.401372213,-12.89782245
1593,2902,,,870,876,1021,1112,1139,,,6,145,91,27,,,0.689655172,16.55251142,8.912830558,2.428057554
1594,741,,,1243,1293,1202,1261,1285,,,50,-91,59,24,,,4.022526146,-7.037896365,4.908485857,1.903251388
1595,1402,,,1006,1051,1085,1175,1188,,,45,34,90,13,,,4.473161034,3.235014272,8.294930876,1.106382979
1596,1293,,,1178,1001,1209,1373,1382,,,-177,208,164,9,,,-15.02546689,20.77922078,13.56492969,0.655498908
1597,648,,,953,956,868,953,919,,,3,-88,85,-34,,,0.314795383,-9.205020921,9.792626728,-3.567681007
1598,1253,,,994,1047,1070,1075,1100,,,53,23,5,25,,,5.331991952,2.196752627,0.46728972,2.325581395
1599,466,,,1253,1176,1358,1409,1599,,,-77,182,51,190,,,-6.145251397,15.47619048,3.755522828,13.48474095
1600,512,,,1044,1036,1071,1055,1139,,,-8,35,-16,84,,,-0.766283525,3.378378378,-1.493930906,7.962085308
1601,723,,,1211,1255,1360,1427,1521,,,44,105,67,94,,,3.633360859,8.366533865,4.926470588,6.587245971
1602,536,,,1135,1126,1250,1286,1252,,,-9,124,36,-34,,,-0.792951542,11.01243339,2.88,-2.643856921
1603,1067,,,898,1066,1097,1135,1161,,,168,31,38,26,,,18.70824053,2.908067542,3.463992707,2.290748899
1604,2383,,,823,844,1025,1127,1168,,,21,181,102,41,,,2.55164034,21.44549763,9.951219512,3.63797693
1605,602,,,906,952,964,1021,985,,,46,12,57,-36,,,5.077262693,1.260504202,5.912863071,-3.525954946
1606,1423,,,1152,1134,1125,1225,1212,,,-18,-9,100,-13,,,-1.5625,-0.793650794,8.888888889,-1.06122449
1607,699,,,1253,1078,1038,924,908,,,-175,-40,-114,-16,,,-13.96648045,-3.710575139,-10.98265896,-1.731601732
1608,1508,,,1270,1336,1213,1204,1131,,,66,-123,-9,-73,,,5.196850394,-9.206586826,-0.741962077,-6.063122924
1609,544,,,1159,1059,1162,1137,1186,,,-100,103,-25,49,,,-8.628127696,9.726156752,-2.151462995,4.309586631
1610,2108,,,1231,1263,1353,1343,1247,,,32,90,-10,-96,,,2.599512591,7.125890736,-0.7390983,-7.148175726
1611,2325,,,1009,1004,1043,1035,1047,,,-5,39,-8,12,,,-0.495540139,3.884462151,-0.767018217,1.15942029
1612,1474,,,1250,1243,1193,1221,1239,,,-7,-50,28,18,,,-0.56,-4.022526146,2.347024308,1.474201474
1613,161,,,1396,1453,1558,1739,1786,,,57,105,181,47,,,4.083094556,7.22642808,11.61745828,2.702702703
1614,1495,,,866,772,842,875,897,,,-94,70,33,22,,,-10.85450346,9.067357513,3.919239905,2.514285714
1615,886,,,1171,1150,1241,1341,1450,,,-21,91,100,109,,,-1.793339026,7.913043478,8.058017728,8.128262491
1616,2334,,,910,904,847,889,936,,,-6,-57,42,47,,,-0.659340659,-6.305309735,4.958677686,5.286839145
1617,902,,,888,975,1002,1103,1140,,,87,27,101,37,,,9.797297297,2.769230769,10.07984032,3.354487761
1618,98,,,1448,1488,1470,1515,1567,,,40,-18,45,52,,,2.762430939,-1.209677419,3.06122449,3.432343234
1619,1216,,,1264,1392,1359,1402,1492,,,128,-33,43,90,,,10.12658228,-2.370689655,3.164091244,6.419400856
1620,2376,,,997,972,929,1019,980,,,-25,-43,90,-39,,,-2.507522568,-4.423868313,9.687836383,-3.827281649
1621,2135,,,749,746,766,828,816,,,-3,20,62,-12,,,-0.400534045,2.680965147,8.093994778,-1.449275362
1622,410,,,889,971,883,957,1120,,,82,-88,74,163,,,9.223847019,-9.062821833,8.380520951,17.03239289
1623,738,,,1218,1232,1269,1274,1278,,,14,37,5,4,,,1.149425287,3.003246753,0.394011032,0.313971743
1624,706,,,1191,1364,1407,1488,1603,,,173,43,81,115,,,14.52560873,3.152492669,5.756929638,7.728494624
1625,647,,,905,954,932,1029,1049,,,49,-22,97,20,,,5.414364641,-2.306079665,10.40772532,1.943634597
1626,2255,,,1147,1146,1218,1117,919,,,-1,72,-101,-198,,,-0.087183958,6.282722513,-8.29228243,-17.72605192
1627,1196,,,1192,1212,1313,1306,1298,,,20,101,-7,-8,,,1.677852349,8.333333333,-0.533130236,-0.612557427
1628,1354,,,910,981,1044,1247,1086,,,71,63,203,-161,,,7.802197802,6.422018349,19.44444444,-12.91098637
1629,379,,,1057,1145,1067,973,1187,,,88,-78,-94,214,,,8.325449385,-6.812227074,-8.809746954,21.9938335
1630,1256,,,964,981,982,1042,1116,,,17,1,60,74,,,1.763485477,0.101936799,6.109979633,7.101727447
1631,1767,,,847,880,928,933,943,,,33,48,5,10,,,3.896103896,5.454545455,0.538793103,1.071811361
1632,2714,,,1154,1190,1319,1179,1064,,,36,129,-140,-115,,,3.119584055,10.84033613,-10.61410159,-9.754028838
1633,1122,,,1028,1160,1256,1335,1248,,,132,96,79,-87,,,12.84046693,8.275862069,6.289808917,-6.516853933
1634,1367,,,1585,1737,1634,1751,1743,,,152,-103,117,-8,,,9.589905363,-5.929763961,7.160342717,-0.456881782
1635,798,,,1034,1088,1036,949,974,,,54,-52,-87,25,,,5.222437137,-4.779411765,-8.397683398,2.634351949
1636,1998,,,920,962,888,938,964,,,42,-74,50,26,,,4.565217391,-7.692307692,5.630630631,2.771855011
1637,1380,,,1043,1058,1021,1208,1389,,,15,-37,187,181,,,1.438159156,-3.497164461,18.31537708,14.98344371
1638,994,,,1216,1229,1209,1243,1180,,,13,-20,34,-63,,,1.069078947,-1.6273393,2.812241522,-5.068382944
1639,365,,,1026,956,1046,821,818,,,-70,90,-225,-3,,,-6.822612086,9.414225941,-21.51051625,-0.365408039
1640,1939,,,1186,1183,1136,1123,1138,,,-3,-47,-13,15,,,-0.252951096,-3.972950127,-1.144366197,1.335707925
1641,1424,,,1062,926,967,964,1003,,,-136,41,-3,39,,,-12.80602637,4.427645788,-0.310237849,4.045643154
1642,2320,,,885,915,954,953,1097,,,30,39,-1,144,,,3.389830508,4.262295082,-0.104821803,15.11017838
1643,790,,,1025,935,930,1075,1097,,,-90,-5,145,22,,,-8.780487805,-0.534759358,15.59139785,2.046511628
1644,279,,,1041,1038,1147,1102,1190,,,-3,109,-45,88,,,-0.288184438,10.50096339,-3.923278117,7.985480944
1645,611,,,1398,1386,1342,1462,1452,,,-12,-44,120,-10,,,-0.858369099,-3.174603175,8.941877794,-0.683994528
1646,1947,,,849,852,896,938,1065,,,3,44,42,127,,,0.35335689,5.164319249,4.6875,13.53944563
1647,1612,,,1182,1160,1180,1215,1116,,,-22,20,35,-99,,,-1.861252115,1.724137931,2.966101695,-8.148148148
1648,1382,,,1257,1352,1381,1455,1599,,,95,29,74,144,,,7.557677009,2.144970414,5.358435916,9.896907216
1649,387,,,1004,980,1040,1003,1040,,,-24,60,-37,37,,,-2.390438247,6.12244898,-3.557692308,3.6889332
1650,1908,,,889,929,961,1028,1137,,,40,32,67,109,,,4.49943757,3.444564047,6.971904266,10.60311284
1651,1899,,,885,952,930,988,980,,,67,-22,58,-8,,,7.570621469,-2.31092437,6.23655914,-0.809716599
1652,1803,,,1590,1625,1566,1692,1755,,,35,-59,126,63,,,2.201257862,-3.630769231,8.045977011,3.723404255
1653,626,,,1229,1252,1286,1337,1343,,,23,34,51,6,,,1.871440195,2.715654952,3.965785381,0.448765894
1654,1925,,,847,850,913,1032,998,,,3,63,119,-34,,,0.354191263,7.411764706,13.033954,-3.294573643
1655,2112,,,1079,1077,1113,1151,1031,,,-2,36,38,-120,,,-0.185356812,3.342618384,3.414195867,-10.42571677
1656,1455,,,1146,1270,1343,1260,1230,,,124,73,-83,-30,,,10.82024433,5.748031496,-6.180193596,-2.380952381
1657,1114,,,1583,1660,1510,1826,1645,,,77,-150,316,-181,,,4.864181933,-9.036144578,20.92715232,-9.91237678
1658,1733,,,952,988,882,971,1023,,,36,-106,89,52,,,3.781512605,-10.72874494,10.09070295,5.355303811
1659,1644,,,1140,1081,1163,1102,1139,,,-59,82,-61,37,,,-5.175438596,7.585568918,-5.24505589,3.35753176
1660,960,,,944,969,934,1026,988,,,25,-35,92,-38,,,2.648305085,-3.611971104,9.850107066,-3.703703704
1661,2277,,,980,950,883,952,1026,,,-30,-67,69,74,,,-3.06122449,-7.052631579,7.814269536,7.773109244
1662,1202,,,1546,1564,1643,1784,1838,,,18,79,141,54,,,1.164294955,5.051150895,8.581862447,3.02690583
1663,2949,,,1173,1113,1138,1122,1061,,,-60,25,-16,-61,,,-5.115089514,2.246181491,-1.405975395,-5.436720143
1664,367,,,987,850,893,941,904,,,-137,43,48,-37,,,-13.8804458,5.058823529,5.375139978,-3.931987248
1665,3090,,,1086,1073,1200,1254,1277,,,-13,127,54,23,,,-1.197053407,11.8359739,4.5,1.834130781
1666,299,,,1489,1445,1452,1459,1429,,,-44,7,7,-30,,,-2.955003358,0.484429066,0.482093664,-2.056202879
1667,2478,,,1301,1232,1268,1294,1116,,,-69,36,26,-178,,,-5.303612606,2.922077922,2.050473186,-13.75579598
1668,1223,,,833,876,938,938,1060,,,43,62,0,122,,,5.162064826,7.077625571,0,13.00639659
1669,865,,,1125,1203,1158,1121,1122,,,78,-45,-37,1,,,6.933333333,-3.740648379,-3.195164076,0.089206066
1670,1556,,,1043,871,1085,1084,1145,,,-172,214,-1,61,,,-16.49089166,24.56946039,-0.092165899,5.627306273
1671,567,,,800,818,904,954,922,,,18,86,50,-32,,,2.25,10.51344743,5.530973451,-3.354297694
1672,1479,,,1205,841,1063,1106,1044,,,-364,222,43,-62,,,-30.20746888,26.39714625,4.045155221,-5.605786618
1673,729,,,1021,1043,1077,1099,1089,,,22,34,22,-10,,,2.154750245,3.259827421,2.042711235,-0.909918107
1674,1334,,,730,751,767,791,696,,,21,16,24,-95,,,2.876712329,2.130492676,3.129074316,-12.01011378
1675,1777,,,884,859,940,1011,1114,,,-25,81,71,103,,,-2.828054299,9.429569267,7.553191489,10.18793274
1676,1624,,,1156,1176,1120,1076,1043,,,20,-56,-44,-33,,,1.730103806,-4.761904762,-3.928571429,-3.066914498
1677,1197,,,1216,1281,1367,1412,1405,,,65,86,45,-7,,,5.345394737,6.713505074,3.291880029,-0.495750708
1678,2000,,,883,926,888,950,977,,,43,-38,62,27,,,4.869762174,-4.103671706,6.981981982,2.842105263
1679,423,,,1064,1092,1177,1201,1233,,,28,85,24,32,,,2.631578947,7.783882784,2.039082413,2.664446295
1680,1828,,,839,858,921,935,992,,,19,63,14,57,,,2.264600715,7.342657343,1.520086862,6.096256684
1681,2014,,,946,986,1095,1096,1098,,,40,109,1,2,,,4.22832981,11.05476673,0.091324201,0.182481752
1682,1743,,,965,957,973,941,1037,,,-8,16,-32,96,,,-0.829015544,1.671891327,-3.288797533,10.20191286
1683,2240,,,1016,1086,1079,1053,1084,,,70,-7,-26,31,,,6.88976378,-0.644567219,-2.409638554,2.943969611
1684,2870,,,1115,1219,1251,1253,1351,,,104,32,2,98,,,9.32735426,2.625102543,0.159872102,7.82122905
1685,1239,,,930,1123,1098,1138,1248,,,193,-25,40,110,,,20.75268817,-2.226179875,3.64298725,9.666080844
1686,221,,,951,902,920,953,910,,,-49,18,33,-43,,,-5.152471083,1.99556541,3.586956522,-4.512067156
1687,669,,,1228,1271,1254,1241,1208,,,43,-17,-13,-33,,,3.501628664,-1.337529504,-1.036682616,-2.65914585
1688,1501,,,1366,1272,1313,1466,1404,,,-94,41,153,-62,,,-6.881405564,3.22327044,11.65270373,-4.229195089
1689,323,,,907,921,951,1039,1148,,,14,30,88,109,,,1.543550165,3.25732899,9.253417455,10.49085659
1690,1184,,,1106,1197,1205,1243,1293,,,91,8,38,50,,,8.227848101,0.66833751,3.153526971,4.022526146
1691,696,,,1045,1055,1195,1270,1366,,,10,140,75,96,,,0.956937799,13.27014218,6.276150628,7.559055118
1692,1307,,,1145,1161,1197,1295,1351,,,16,36,98,56,,,1.397379913,3.100775194,8.187134503,4.324324324
1693,197,,,1084,1189,1055,1094,1031,,,105,-134,39,-63,,,9.686346863,-11.26997477,3.696682464,-5.758683729
1694,1741,,,1031,1046,914,1011,1103,,,15,-132,97,92,,,1.454898157,-12.61950287,10.61269147,9.099901088
1695,1498,,,881,1033,1226,1244,1204,,,152,193,18,-40,,,17.25312145,18.68344627,1.468189233,-3.215434084
1696,858,,,1313,1476,1395,1514,1505,,,163,-81,119,-9,,,12.41431835,-5.487804878,8.53046595,-0.594451783
1697,1379,,,1235,1240,1291,1391,1330,,,5,51,100,-61,,,0.4048583,4.112903226,7.745933385,-4.385334292
1698,1638,,,1046,1050,1065,1132,1248,,,4,15,67,116,,,0.382409178,1.428571429,6.291079812,10.24734982
1699,401,,,972,919,693,841,786,,,-53,-226,148,-55,,,-5.452674897,-24.59194777,21.35642136,-6.539833532
1700,1814,,,1137,1120,1172,1293,1332,,,-17,52,121,39,,,-1.495162709,4.642857143,10.32423208,3.016241299
1701,289,,,1244,1211,1260,1232,1249,,,-33,49,-28,17,,,-2.652733119,4.046242775,-2.222222222,1.37987013
1702,1974,,,878,891,993,1089,1211,,,13,102,96,122,,,1.480637813,11.44781145,9.667673716,11.20293848
1703,1471,,,1036,1074,1166,1223,1215,,,38,92,57,-8,,,3.667953668,8.566108007,4.888507719,-0.654129191
1704,750,,,1069,1144,1224,1319,1408,,,75,80,95,89,,,7.015902713,6.993006993,7.761437908,6.747536012
1705,1869,,,926,833,815,840,877,,,-93,-18,25,37,,,-10.04319654,-2.160864346,3.067484663,4.404761905
1706,1570,,,886,943,1065,1082,1140,,,57,122,17,58,,,6.433408578,12.93743372,1.596244131,5.360443623
1707,1249,,,1069,1170,1102,1110,1105,,,101,-68,8,-5,,,9.44808232,-5.811965812,0.725952813,-0.45045045
1708,1324,,,1273,1357,1345,1325,1351,,,84,-12,-20,26,,,6.598586017,-0.884303611,-1.486988848,1.962264151
1709,141,,,991,845,906,888,970,,,-146,61,-18,82,,,-14.73259334,7.218934911,-1.986754967,9.234234234
1710,1685,,,599,592,784,785,791,,,-7,192,1,6,,,-1.168614357,32.43243243,0.12755102,0.76433121
1711,2485,,,1171,1167,1214,1183,1146,,,-4,47,-31,-37,,,-0.341588386,4.027420737,-2.55354201,-3.127641589
1712,1345,,,1112,972,962,944,887,,,-140,-10,-18,-57,,,-12.58992806,-1.028806584,-1.871101871,-6.038135593
1713,1637,,,955,983,975,1074,1073,,,28,-8,99,-1,,,2.931937173,-0.813835198,10.15384615,-0.09310987
1714,1975,,,1032,1141,1014,1133,1172,,,109,-127,119,39,,,10.5620155,-11.1305872,11.7357002,3.442188879
1715,785,,,923,941,994,1016,1147,,,18,53,22,131,,,1.950162514,5.632306057,2.213279678,12.89370079
1716,302,,,1026,879,988,913,1080,,,-147,109,-75,167,,,-14.32748538,12.40045506,-7.591093117,18.29134721
1717,1608,,,956,994,1010,955,942,,,38,16,-55,-13,,,3.974895397,1.609657948,-5.445544554,-1.361256545
1718,1386,,,1559,1850,1688,1753,1708,,,291,-162,65,-45,,,18.66581142,-8.756756757,3.8507109,-2.567027952
1719,2164,,,992,1052,1046,1062,1078,,,60,-6,16,16,,,6.048387097,-0.570342205,1.529636711,1.506591337
1720,731,,,1106,1150,1191,1209,1215,,,44,41,18,6,,,3.978300181,3.565217391,1.511335013,0.496277916
1721,33,,,1057,1093,1076,1090,1157,,,36,-17,14,67,,,3.405865658,-1.555352242,1.301115242,6.146788991
1722,2445,,,890,898,872,986,1108,,,8,-26,114,122,,,0.898876404,-2.89532294,13.0733945,12.37322515
1723,1278,,,1086,1172,1092,1143,1194,,,86,-80,51,51,,,7.918968692,-6.825938567,4.67032967,4.461942257
1724,1349,,,1167,1196,1242,1276,1339,,,29,46,34,63,,,2.485004284,3.846153846,2.737520129,4.937304075
1725,386,,,1068,1271,1213,1302,1306,,,203,-58,89,4,,,19.00749064,-4.563335956,7.337180544,0.307219662
1726,1431,,,2310,2626,3041,3179,3170,,,316,415,138,-9,,,13.67965368,15.80350343,4.537980927,-0.283107896
1727,1773,,,1135,1152,1181,1203,1224,,,17,29,22,21,,,1.497797357,2.517361111,1.862828112,1.74563591
1728,1290,,,1059,1081,1128,1104,1055,,,22,47,-24,-49,,,2.077431539,4.347826087,-2.127659574,-4.438405797
1729,1472,,,791,800,830,886,887,,,9,30,56,1,,,1.137800253,3.75,6.746987952,0.112866817
1730,1375,,,1354,1318,1234,1397,1318,,,-36,-84,163,-79,,,-2.658788774,-6.373292868,13.20907618,-5.654974946
1731,325,,,860,1018,876,894,838,,,158,-142,18,-56,,,18.37209302,-13.94891945,2.054794521,-6.263982103
1732,2539,,,1847,1648,1852,1863,2053,,,-199,204,11,190,,,-10.77422848,12.37864078,0.593952484,10.1986044
1733,662,,,1079,1081,1125,1119,1130,,,2,44,-6,11,,,0.185356812,4.070305273,-0.533333333,0.983020554
1734,419,,,810,865,879,809,858,,,55,14,-70,49,,,6.790123457,1.61849711,-7.963594994,6.056860321
1735,470,,,746,743,753,776,755,,,-3,10,23,-21,,,-0.402144772,1.34589502,3.054448871,-2.706185567
1736,2956,,,862,894,835,859,923,,,32,-59,24,64,,,3.712296984,-6.599552573,2.874251497,7.450523865
1737,1421,,,1208,1358,1397,1349,1180,,,150,39,-48,-169,,,12.41721854,2.871870398,-3.435934145,-12.52779837
1738,1487,,,816,824,799,837,819,,,8,-25,38,-18,,,0.980392157,-3.033980583,4.755944931,-2.150537634
1739,1621,,,895,944,965,1065,1207,,,49,21,100,142,,,5.474860335,2.224576271,10.3626943,13.33333333
1740,2233,,,988,1061,1124,1130,1082,,,73,63,6,-48,,,7.388663968,5.937794533,0.533807829,-4.247787611
1741,799,,,1219,1424,1365,1444,1434,,,205,-59,79,-10,,,16.81706317,-4.143258427,5.787545788,-0.692520776
1742,1207,,,1273,1236,1479,1512,1391,,,-37,243,33,-121,,,-2.906520031,19.66019417,2.231237323,-8.002645503
1743,822,,,1118,1273,1267,1387,1307,,,155,-6,120,-80,,,13.86404293,-0.471327573,9.471191792,-5.767844268
1744,1235,,,1171,1125,1219,1250,1256,,,-46,94,31,6,,,-3.928266439,8.355555556,2.543068089,0.48
1745,234,,,1044,939,1058,1049,1121,,,-105,119,-9,72,,,-10.05747126,12.67305644,-0.850661626,6.863679695
1746,2338,,,828,907,963,1030,1139,,,79,56,67,109,,,9.541062802,6.174200662,6.957424714,10.58252427
1747,1923,,,977,1091,981,1101,1119,,,114,-110,120,18,,,11.66837257,-10.08249313,12.2324159,1.634877384
1748,1753,,,1261,1232,1313,1184,1266,,,-29,81,-129,82,,,-2.299762094,6.574675325,-9.824828637,6.925675676
1749,1827,,,835,840,910,940,1019,,,5,70,30,79,,,0.598802395,8.333333333,3.296703297,8.404255319
1750,1361,,,1092,1111,1195,1299,1340,,,19,84,104,41,,,1.73992674,7.560756076,8.70292887,3.156274057
1751,273,,,1006,931,1234,1185,1260,,,-75,303,-49,75,,,-7.45526839,32.54564984,-3.97082658,6.329113924
1752,3011,,,903,942,924,1142,1085,,,39,-18,218,-57,,,4.318936877,-1.910828025,23.59307359,-4.991243433
1753,1907,,,1282,1346,1204,1248,1208,,,64,-142,44,-40,,,4.992199688,-10.54977712,3.65448505,-3.205128205
1754,2216,,,1709,1487,1645,1603,1506,,,-222,158,-42,-97,,,-12.99005266,10.62542031,-2.553191489,-6.051154086
1755,2386,,,1063,1025,1197,1171,1047,,,-38,172,-26,-124,,,-3.574788335,16.7804878,-2.172096909,-10.58923997
1756,2892,,,842,870,980,1057,1062,,,28,110,77,5,,,3.325415677,12.64367816,7.857142857,0.473036897
1757,747,,,1035,1103,993,1046,1032,,,68,-110,53,-14,,,6.570048309,-9.972801451,5.337361531,-1.338432122
1758,218,,,1113,1113,1149,1228,1197,,,0,36,79,-31,,,0,3.234501348,6.875543951,-2.524429967
1759,2508,,,1141,1123,1172,1199,1179,,,-18,49,27,-20,,,-1.577563541,4.363312556,2.303754266,-1.668056714
1760,2531,,,890,961,1111,1073,1038,,,71,150,-38,-35,,,7.97752809,15.60874089,-3.420342034,-3.261882572
1761,1611,,,912,825,885,959,1078,,,-87,60,74,119,,,-9.539473684,7.272727273,8.361581921,12.40875912
1762,2452,,,1583,1308,1663,2026,2323,,,-275,355,363,297,,,-17.37207833,27.14067278,21.82802165,14.65942744
1763,2510,,,1139,1068,1035,1159,1038,,,-71,-33,124,-121,,,-6.233538191,-3.08988764,11.98067633,-10.44003451
1764,2272,,,984,1039,1066,1088,1084,,,55,27,22,-4,,,5.589430894,2.598652551,2.063789869,-0.367647059
1765,258,,,1064,762,842,862,933,,,-302,80,20,71,,,-28.38345865,10.49868766,2.375296912,8.236658933
1766,2868,,,945,939,849,892,930,,,-6,-90,43,38,,,-0.634920635,-9.584664537,5.064782097,4.260089686
1767,519,,,1282,1281,1338,1445,1445,,,-1,57,107,0,,,-0.07800312,4.449648712,7.997010463,0
1768,742,,,1018,1102,1197,1346,1422,,,84,95,149,76,,,8.251473477,8.620689655,12.44778613,5.646359584
1769,1656,,,1085,1089,1249,1225,1225,,,4,160,-24,0,,,0.368663594,14.69237833,-1.92153723,0
1770,1515,,,1294,1503,1455,1465,1398,,,209,-48,10,-67,,,16.15146832,-3.193612774,0.687285223,-4.57337884
1771,1560,,,1179,1192,1195,1203,1154,,,13,3,8,-49,,,1.102629347,0.251677852,0.669456067,-4.073150457
1772,212,,,1083,1086,1047,1079,1066,,,3,-39,32,-13,,,0.27700831,-3.591160221,3.05635148,-1.204819277
1773,1244,,,1351,1475,1567,1522,1445,,,124,92,-45,-77,,,9.17838638,6.237288136,-2.871729419,-5.05913272
1774,1166,,,1286,1364,1393,1447,1534,,,78,29,54,87,,,6.065318818,2.126099707,3.876525485,6.01243953
1775,1323,,,1115,1139,1285,1195,1144,,,24,146,-90,-51,,,2.152466368,12.81826163,-7.003891051,-4.267782427
1776,1999,,,859,835,800,802,833,,,-24,-35,2,31,,,-2.793946449,-4.191616766,0.25,3.865336658
1777,1319,,,1223,1235,1177,1193,1231,,,12,-58,16,38,,,0.981193786,-4.696356275,1.359388275,3.185247276
1778,1257,,,1188,921,839,1216,1065,,,-267,-82,377,-151,,,-22.47474747,-8.903365907,44.93444577,-12.41776316
1779,1299,,,1423,1526,1553,1748,1728,,,103,27,195,-20,,,7.238229093,1.769331586,12.55634256,-1.14416476
1780,514,,,1123,1058,1176,1148,1190,,,-65,118,-28,42,,,-5.788067676,11.15311909,-2.380952381,3.658536585
1781,736,,,871,859,861,794,821,,,-12,2,-67,27,,,-1.377726751,0.232828871,-7.781649245,3.400503778
1782,1855,,,869,954,976,955,1009,,,85,22,-21,54,,,9.781357883,2.306079665,-2.151639344,5.654450262
1783,1950,,,759,751,854,808,819,,,-8,103,-46,11,,,-1.054018445,13.7150466,-5.386416862,1.361386139
1784,1681,,,789,758,802,812,840,,,-31,44,10,28,,,-3.929024081,5.80474934,1.246882793,3.448275862
1785,575,,,946,874,880,958,1009,,,-72,6,78,51,,,-7.610993658,0.686498856,8.863636364,5.323590814
1786,733,,,1210,1170,1232,1258,1256,,,-40,62,26,-2,,,-3.305785124,5.299145299,2.11038961,-0.158982512
1787,2138,,,1065,1130,948,1019,1018,,,65,-182,71,-1,,,6.103286385,-16.10619469,7.489451477,-0.098135427
1788,405,,,1019,1070,1121,1263,1207,,,51,51,142,-56,,,5.004906771,4.76635514,12.66726137,-4.433887569
1789,2001,,,1524,1318,1385,1396,1255,,,-206,67,11,-141,,,-13.51706037,5.083459788,0.794223827,-10.10028653
1790,1649,,,2350,2859,2732,2928,3033,,,509,-127,196,105,,,21.65957447,-4.442112627,7.174231332,3.586065574
1791,1579,,,1261,1263,1302,1396,1390,,,2,39,94,-6,,,0.158604282,3.087885986,7.219662058,-0.429799427
1792,1329,,,1161,1243,1130,1263,1290,,,82,-113,133,27,,,7.06287683,-9.090909091,11.7699115,2.137767221
1793,1699,,,1177,1157,1125,1178,1225,,,-20,-32,53,47,,,-1.699235344,-2.765773552,4.711111111,3.989813243
1794,1966,,,1284,1295,1376,1492,1562,,,11,81,116,70,,,0.856697819,6.254826255,8.430232558,4.691689008
1795,1486,,,1139,1272,1241,1251,1303,,,133,-31,10,52,,,11.67690957,-2.437106918,0.805801773,4.15667466
1796,2934,,,921,948,844,922,1048,,,27,-104,78,126,,,2.931596091,-10.97046414,9.241706161,13.6659436
1797,220,,,1101,1049,1062,1156,1164,,,-52,13,94,8,,,-4.72297911,1.2392755,8.851224105,0.692041522
1798,1412,,,894,922,977,1039,1167,,,28,55,62,128,,,3.131991051,5.965292842,6.345957011,12.31953802
1799,1706,,,1163,1201,1257,1069,821,,,38,56,-188,-248,,,3.267411866,4.662781016,-14.95624503,-23.19925164
1800,227,,,1496,1440,1470,1524,1591,,,-56,30,54,67,,,-3.743315508,2.083333333,3.673469388,4.396325459
1801,837,,,1078,1074,1179,1183,1274,,,-4,105,4,91,,,-0.371057514,9.776536313,0.339270568,7.692307692
1802,1189,,,1244,1389,1318,1349,1443,,,145,-71,31,94,,,11.65594855,-5.111591073,2.352048558,6.968124537
1803,1415,,,936,913,927,939,931,,,-23,14,12,-8,,,-2.457264957,1.533406353,1.294498382,-0.851970181
1804,1416,,,980,1036,994,1049,1089,,,56,-42,55,40,,,5.714285714,-4.054054054,5.533199195,3.813155386
1805,1625,,,1034,1040,1160,1193,1240,,,6,120,33,47,,,0.580270793,11.53846154,2.844827586,3.939647946
1806,363,,,1233,1470,1443,1409,1299,,,237,-27,-34,-110,,,19.22141119,-1.836734694,-2.356202356,-7.806955287
1807,2390,,,1063,1069,1125,1107,986,,,6,56,-18,-121,,,0.564440263,5.238540692,-1.6,-10.93044264
1808,1700,,,1015,964,1057,1115,1147,,,-51,93,58,32,,,-5.024630542,9.647302905,5.487228004,2.869955157
1809,1308,,,1196,1257,1285,1293,1361,,,61,28,8,68,,,5.100334448,2.227525855,0.622568093,5.259087394
1810,532,,,1228,1423,1363,1426,1498,,,195,-60,63,72,,,15.87947883,-4.216444132,4.622157007,5.049088359
1811,122,,,1813,1818,1720,1730,1901,,,5,-98,10,171,,,0.27578599,-5.390539054,0.581395349,9.884393064
1812,1245,,,1072,1141,1127,1189,1254,,,69,-14,62,65,,,6.436567164,-1.226993865,5.501330967,5.466778806
1813,711,,,674,773,696,753,812,,,99,-77,57,59,,,14.6884273,-9.961190168,8.189655172,7.835325365
1814,173,,,1243,1266,1435,1518,1591,,,23,169,83,73,,,1.850362027,13.34913112,5.783972125,4.808959157
1815,2210,,,1291,1341,1409,1428,1338,,,50,68,19,-90,,,3.872966692,5.070842655,1.348474095,-6.302521008
1816,2513,,,1448,1447,1543,1538,1443,,,-1,96,-5,-95,,,-0.069060773,6.634416033,-0.32404407,-6.176853056
1817,2418,,,1078,1101,1129,1096,1071,,,23,28,-33,-25,,,2.133580705,2.543142598,-2.922940655,-2.281021898
1818,1571,,,1071,1105,1146,1254,1321,,,34,41,108,67,,,3.174603175,3.71040724,9.42408377,5.342902711
1819,1444,,,1003,1059,964,986,998,,,56,-95,22,12,,,5.583250249,-8.970727101,2.282157676,1.21703854
1820,1456,,,1157,1153,1110,970,843,,,-4,-43,-140,-127,,,-0.345721694,-3.729401561,-12.61261261,-13.09278351
1821,644,,,1347,1407,1404,1472,1476,,,60,-3,68,4,,,4.454342984,-0.213219616,4.843304843,0.27173913
1822,546,,,1499,1540,1656,1468,1458,,,41,116,-188,-10,,,2.735156771,7.532467532,-11.352657,-0.68119891
1823,1219,,,1074,1084,983,1054,1059,,,10,-101,71,5,,,0.931098696,-9.317343173,7.222787386,0.474383302
1824,244,,,893,976,934,908,987,,,83,-42,-26,79,,,9.294512878,-4.303278689,-2.78372591,8.700440529
1825,364,,,875,843,875,964,1001,,,-32,32,89,37,,,-3.657142857,3.795966785,10.17142857,3.838174274
1826,2610,,,968,993,936,1074,964,,,25,-57,138,-110,,,2.582644628,-5.740181269,14.74358974,-10.24208566
1827,810,,,1261,1266,1218,1192,1202,,,5,-48,-26,10,,,0.396510706,-3.791469194,-2.134646962,0.838926174
1828,2488,,,1099,1166,1161,1198,1214,,,67,-5,37,16,,,6.096451319,-0.428816467,3.186907838,1.335559265
1829,1294,,,984,989,1240,1293,1295,,,5,251,53,2,,,0.508130081,25.37917088,4.274193548,0.154679041
1830,216,,,1325,1211,1448,1505,1527,,,-114,237,57,22,,,-8.603773585,19.57060281,3.936464088,1.46179402
1831,3034,,,,,,1069,801,,,,,,-268,,,,,,-25.07015903
1832,2964,,,,,,1014,741,,,,,,-273,,,,,,-26.92307692
1833,2303,,,,,,753,786,,,,,,33,,,,,,4.38247012
1834,1972,,,,,,795,766,,,,,,-29,,,,,,-3.647798742
1835,2016,,,,,,769,778,,,,,,9,,,,,,1.170351105
1836,2864,,,,,,,834,,,,,,,,,,,,
1837,2503,,,,,,,926,,,,,,,,,,,,
1838,2366,,,,,,,778,,,,,,,,,,,,
1839,1807,,,,,,,829,,,,,,,,,,,,
1840,2468,,,,,,,1091,,,,,,,,,,,,
1841,2188,,,,,,,773,,,,,,,,,,,,
1842,2447,,,,,,,972,,,,,,,,,,,,
1843,2896,,,,,,,907,,,,,,,,,,,,
1844,2885,,,,,,,795,,,,,,,,,,,,
1845,2520,,,,,,,1198,,,,,,,,,,,,
